(supertux-level
  (version 3)
  (name (_ "Slidin' Around at the Speed Of Sound"))
  (author "Sophie Ball")
  (note (_ "Got places to go... (Act 1)"))
  (license "CC-BY-SA 4.0 International")
  (target-time 96)
  (allow-item-pocket "inherit")
  (icon "")
  (icon-locked "")
  (statistics
    (enable-coins #t)
    (enable-badguys #f)
    (enable-secrets #t)
  )
  (sector
    (name "main")
    (ambient-light
      (color 1 1 1)
    )
    (background
      (color 1 1 1)
      (alignment "bottom")
      (speed 0.25)
      (image "images/background/antarctic/arctis2.png")
    )
    (bonusblock
      (type "purple")
      (z-pos 51)
      (x 10848)
      (y 1184)
    )
    (camera
      (name "Camera")
      (mode "normal")
    )
    (captainsnowball
      (z-pos 50)
      (sprite "/images/creatures/snowball/captain-snowball.sprite")
      (x 16832)
      (y 1696)
    )
    (dispenser
      (z-pos 55)
      (cycle 2.5)
      (type "cannon")
      (objects
        (bigsnowball
          (z-pos 50)
          (direction "left")
          (bounce #f)
        )
      )
      (direction "left")
      (x 8192)
      (y 1568)
    )
    (dispenser
      (z-pos 55)
      (cycle 2.5)
      (type "cannon")
      (objects
        (bigsnowball
          (z-pos 50)
          (direction "left")
          (bounce #f)
        )
      )
      (direction "left")
      (x 9152)
      (y 1504)
    )
    (firefly
      (z-pos 0)
      (x 15152)
      (y 1504)
    )
    (flyingsnowball
      (z-pos 50)
      (x 10432)
      (y 1472)
    )
    (gradient
      (top_color 0.3 0.4 0.75)
      (bottom_color 1 1 1)
      (z-pos -301)
    )
    (infoblock
      (z-pos 51)
      (message (_ "Tip: Normal jump, not slide jump.
But make sure to slide before jumping."))
      (x 32)
      (y 1184)
    )
    (jumpy
      (z-pos 50)
      (x 4576)
      (y 1824)
    )
    (jumpy
      (z-pos 50)
      (x 9872)
      (y 1408)
    )
    (jumpy
      (z-pos 50)
      (x 16320)
      (y 1440)
    )
    (jumpy
      (z-pos 50)
      (x 16032)
      (y 1440)
    )
    (mriceblock
      (z-pos 50)
      (x 3296)
      (y 1792)
    )
    (music
      (file "/music/present/midday.music")
    )
    (powerup
      (version 2)
      (type "oneup")
      (z-pos 50)
      (x 10656)
      (y 1472)
    )
    (rock
      (type "large")
      (z-pos 50)
      (x 7744)
      (y 1984)
    )
    (rock
      (type "large")
      (z-pos 50)
      (x 7392)
      (y 1792)
    )
    (rock
      (type "large")
      (z-pos 50)
      (x 7392)
      (y 1856)
    )
    (rock
      (type "large")
      (z-pos 50)
      (x 7264)
      (y 1888)
    )
    (rock
      (type "large")
      (z-pos 50)
      (x 16864)
      (y 1664)
    )
    (rock
      (type "large")
      (z-pos 50)
      (x 16928)
      (y 1664)
    )
    (rock
      (type "large")
      (z-pos 50)
      (x 18464)
      (y 1376)
    )
    (rock
      (type "large")
      (z-pos 50)
      (x 16992)
      (y 1664)
    )
    (secretarea
      (message (_ "You found the Tux Doll!"))
      (width 32)
      (height 64)
      (x 10656)
      (y 1472)
    )
    (sequencetrigger
      (sequence "endsequence")
      (width 32)
      (height 1088)
      (x 18816)
      (y -64)
    )
    (smartball
      (z-pos 50)
      (x 15488)
      (y 1440)
    )
    (smartball
      (z-pos 50)
      (x 15200)
      (y 1440)
    )
    (smartball
      (z-pos 50)
      (x 14880)
      (y 1440)
    )
    (smartblock
      (z-pos 50)
      (x 14720)
      (y 1568)
    )
    (snowball
      (z-pos 50)
      (x 2560)
      (y 1760)
    )
    (snowball
      (z-pos 50)
      (x 5088)
      (y 1888)
    )
    (snowball
      (z-pos 50)
      (x 6432)
      (y 1536)
    )
    (snowball
      (z-pos 50)
      (x 9600)
      (y 1472)
    )
    (snowball
      (z-pos 50)
      (x 15872)
      (y 1504)
    )
    (snowball
      (z-pos 50)
      (x 16000)
      (y 1472)
    )
    (snowball
      (z-pos 50)
      (x 18208)
      (y 1344)
    )
    (snowball
      (z-pos 50)
      (x 12896)
      (y 1056)
    )
    (snowball
      (z-pos 50)
      (x 12768)
      (y 1056)
    )
    (snowman
      (z-pos 50)
      (x 3904)
      (y 1632)
    )
    (spawnpoint
      (name "main")
      (x 32)
      (y 1248)
    )
    (spawnpoint
      (x 6080)
      (y 1504)
    )
    (spawnpoint
      (x 7072)
      (y 1888)
    )
    (spawnpoint
      (x 16480)
      (y 1568)
    )
    (spiky
      (z-pos 50)
      (x 5280)
      (y 1888)
    )
    (spiky
      (z-pos 50)
      (x 5472)
      (y 1856)
    )
    (tilemap
      (solid #f)
      (z-pos -100)
      (width 625)
      (height 65)
      (tiles -15587 0 130 -624 0 129 -624 0 129 -624 0 129 -624 0 129 -15 0 1321 1322 1323 1324 -605 0 129 -15 0 1325 1326 1327 1328 -413 0 1321 1322 1323 1324 -188 0 129 -9 0 106 107 108 -3 0 1329 1330 1331 1332 -8 0 4137 4138 4139 4140 106 107 108 -398 0 1325 1326 1327 1328 -185 0 24 25 0 129 -2 0 2623 2624 24 25 0 24 0 109 110 111 2625 2626 24 1333 1334 1335 1336 25 0 24 -2 0 2623 2624 25 4141 4142 4143 4144 109 110 111 2625 2626 25 -395 0 1329 1330 1331 1332 0 106 107 108 -610 0 25 0 2625 2626 24 25 0 1333 1334 1335 1336 0 109 110 111 -3265 0 106 107 108 -622 0 109 110 111 25 -78 0 24 25 -548 0 24 -642 0 4145 4146 4147 4148 106 107 108 -608 0 2623 2624 -7 0 24 4149 4150 4151 4152 109 110 111 -612 0 25 -436 0 25 -445 0 1321 1322 1323 1324 -103 0 24 -5 0 24 -2 0 4137 4138 4139 4140 -177 0 1321 1322 1323 1324 -6 0 106 107 108 -315 0 1325 1326 1327 1328 -60 0 1321 1322 1323 1324 -32 0 106 107 108 -2 0 24 -9 0 24 4141 4142 4143 4144 0 25 -175 0 1325 1326 1327 1328 -6 0 109 110 111 2625 2626 0 24 2623 2624 -302 0 4137 4138 4139 4140 -3 0 1329 1330 1331 1332 -4 0 106 107 108 4145 4146 4147 4148 -49 0 1325 1326 1327 1328 -32 0 109 110 111 -21 0 24 -172 0 1329 1330 1331 1332 -18 0 24 -298 0 4141 4142 4143 4144 0 24 0 1333 1334 1335 1336 24 0 2623 2624 109 110 111 4149 4150 4151 4152 -49 0 1329 1330 1331 1332 -2 0 24 -7 0 106 107 108 -2 0 24 -2 0 25 0 2623 2624 -4 0 24 0 2625 2626 -135 0 106 107 108 -3 0 25 -29 0 106 107 108 0 4137 4138 4139 4140 -2 0 106 107 108 -15 0 1333 1334 1335 1336 -249 0 1321 1322 1323 1324 -125 0 106 107 108 -7 0 1333 1334 1335 1336 -10 0 109 110 111 -152 0 109 110 111 24 -29 0 25 -2 0 109 110 111 0 4141 4142 4143 4144 25 0 109 110 111 -2 0 24 0 2623 2624 0 25 0 2625 2626 24 -256 0 1325 1326 1327 1328 -125 0 109 110 111 24 0 25 -200 0 2623 2624 -288 0 1329 1330 1331 1332 -621 0 1333 1334 1335 1336 -55 0 106 107 108 -139 0 106 107 108 -4 0 4145 4146 4147 4148 -200 0 106 107 108 -2 0 24 -205 0 24 -6 0 25 -53 0 109 110 111 -139 0 109 110 111 2623 2624 0 25 4149 4150 4151 4152 -11 0 1321 1322 1323 1324 -175 0 106 107 108 -3 0 24 0 25 0 109 110 111 -158 0 4145 4146 4147 4148 0 106 107 108 -33 0 106 107 108 -2 0 24 -61 0 24 -157 0 24 0 25 -6 0 1325 1326 1327 1328 -175 0 109 110 111 -129 0 106 107 108 -2 0 24 -29 0 25 0 2625 2626 4149 4150 4151 4152 0 109 110 111 2623 2624 0 25 -29 0 109 110 111 -228 0 2625 2626 0 1329 1330 1331 1332 106 107 108 -2 0 24 -6 0 2623 2624 -292 0 25 109 110 111 -28 0 24 -22 0 2625 2626 -21 0 25 -236 0 1333 1334 1335 1336 109 110 111 -405 0 24 -4 0 106 107 108 -31 0 106 107 108 -588 0 109 110 111 24 2625 2626 -28 0 109 110 111 -596 0 25 -87 0 2623 2624 -615 0 106 107 108 -12 0 106 107 108 -607 0 109 110 111 -12 0 109 110 111 -2259 0)
    )
    (tilemap
      (solid #f)
      (z-pos 100)
      (width 625)
      (height 65)
      (tiles -15589 0 130 -624 0 129 -624 0 129 -624 0 129 -624 0 129 -624 0 129 -624 0 129 -624 0 129 -20660 0)
    )
    (tilemap
      (solid #t)
      (z-pos 0)
      (width 625)
      (height 65)
      (tiles -340 0 10 -9 11 12 -614 0 10 -9 11 12 -614 0 10 -9 11 12 -614 0 10 -9 11 12 -614 0 10 -9 11 12 -614 0 10 -9 11 12 -614 0 10 -2 11 19 -6 11 12 -614 0 10 11 19 -7 11 12 -614 0 10 11 19 -7 11 12 -614 0 10 -9 11 12 -614 0 10 -9 11 12 -614 0 10 -9 11 12 -614 0 10 -9 11 12 -614 0 10 -9 11 12 -614 0 10 -9 11 12 -614 0 10 -9 11 12 -614 0 10 -9 11 12 -614 0 10 -9 11 12 -614 0 10 -9 11 12 -614 0 10 -9 11 12 -614 0 10 -9 11 12 -614 0 10 -9 11 12 -614 0 10 -9 11 12 -614 0 10 -9 11 12 -614 0 10 -9 11 12 -614 0 10 -9 11 12 -614 0 10 -8 11 19 12 -614 0 10 -9 11 12 -614 0 10 -9 11 12 -614 0 10 -6 11 19 -2 11 12 -614 0 10 -3 11 19 -5 11 12 -614 0 10 -9 11 12 -231 0 2909 2910 -41 8 -340 0 10 -9 11 12 -228 0 7 2921 2922 2911 2912 -2 14 3990 3989 14 3990 -11 14 3990 -2 14 3990 14 3990 -7 14 3988 3990 -9 14 -340 0 10 -9 11 12 -35 0 2909 2910 -14 8 2913 2914 -175 0 13 2923 2924 1834 -42 11 -340 0 10 -9 11 12 -33 0 3141 3142 2911 2912 -14 14 2915 2916 3139 3140 -173 0 10 -21 11 19 -23 11 -340 0 10 -9 11 12 -32 0 1837 3145 3146 1834 -16 11 1835 3143 3144 3149 -172 0 10 -19 11 19 -25 11 -340 0 10 -3 11 19 -5 11 12 -31 0 1837 1839 3148 -20 11 3147 3151 3152 -135 0 -4 83 -32 0 10 -13 11 19 -9 11 19 11 19 -19 11 -340 0 10 -2 11 19 -6 11 12 -30 0 1837 1839 1841 -22 11 3155 3156 3139 3140 -169 0 10 -21 11 19 -23 11 -340 0 10 -2 11 19 -6 11 12 -29 0 1837 1839 1841 -24 11 1835 3143 3144 3149 -53 0 78 83 -7 0 83 102 -7 0 83 78 -95 0 10 11 19 -14 11 19 -28 11 -340 0 10 -9 11 12 -28 0 1843 1839 1841 -27 11 3147 3151 3152 -129 0 2909 2910 -4 8 2913 2914 -30 0 10 -9 11 19 -9 11 19 -25 11 -2 8 2913 2914 -335 0 1837 22 -6 11 19 -2 11 12 -28 0 1845 1841 -11 11 19 -17 11 3155 3156 1832 1827 -124 0 7 2921 2922 2911 2912 3990 -2 14 3989 2915 2916 2917 2918 2913 2914 -26 0 10 -45 11 -2 14 2915 2916 3139 3140 -332 0 1843 1839 23 -7 11 2929 2930 18 -27 0 1837 1847 -14 11 19 -16 11 1835 1836 1831 1832 1827 -122 0 13 2923 2924 1834 -6 11 1835 2919 2920 2915 2916 2917 2918 2913 2914 -22 0 10 -11 11 19 -36 11 1835 3143 3144 3149 -331 0 1845 1841 -7 11 2935 2931 -28 0 3150 1839 1849 19 -18 11 19 -13 11 1835 1836 1831 3139 3140 -45 0 78 -2 83 78 -5 0 78 -2 83 78 -5 0 78 -2 83 78 -53 0 10 -13 11 1835 2919 2920 2915 2916 2917 2918 2913 2914 -4 0 2909 2910 -9 8 9 -2 0 10 -44 11 19 -5 11 3147 3151 3152 -329 0 1837 1847 -7 11 2940 2936 -28 0 3153 3154 1841 -4 11 19 -31 11 1835 3143 3144 1838 -86 0 83 2945 -31 0 10 -17 11 1835 2919 2920 2915 2916 2917 2918 2921 2922 2911 2912 -9 14 15 -2 0 10 -32 11 19 -18 11 3155 3156 3139 3140 -326 0 3150 1839 1849 -7 11 2941 -25 0 2909 2910 2921 2922 3157 3158 -9 11 19 -5 11 19 -23 11 3147 1840 3149 -118 0 10 -19 11 19 11 1835 2919 2920 2923 2924 1834 -10 11 21 -2 8 22 -8 11 19 -43 11 1835 3143 3144 3149 -290 0 7 9 -5 0 7 9 -25 0 3153 3154 1841 -7 11 2935 2942 -23 0 3141 3142 2911 2912 2923 2924 1834 -16 11 19 -13 11 19 -4 11 19 -5 11 1842 3151 3152 -117 0 10 -3 11 19 -33 11 20 -2 14 23 -27 11 19 -26 11 3147 3151 3152 -286 0 2909 2910 8 114 113 -5 2178 114 113 -6 8 2913 2914 -14 0 7 2921 2922 3157 3158 -7 11 2935 2936 -23 0 1837 3145 3146 1834 -6 11 19 -12 11 19 -2 11 19 -19 11 19 -3 11 3155 3156 1832 1827 -39 0 78 -4 83 78 -3 0 78 -4 83 78 -3 0 78 -4 83 78 -14 0 2909 2910 -8 8 2913 2914 -26 0 10 -90 11 19 -5 11 3155 3156 1832 1827 -280 0 2909 2910 2921 2922 2911 2912 14 23 20 -5 14 23 20 -2 14 3988 -3 14 2915 2916 2917 2918 9 -11 0 13 2923 2924 1834 -7 11 2935 2936 -23 0 1837 1839 3148 -16 11 19 -32 11 1835 1836 1831 1832 1827 -71 0 2909 2910 2921 2922 2911 2912 14 3990 -6 14 2915 2916 2917 2918 9 -23 0 10 -18 11 19 -54 11 19 -23 11 1835 1836 1831 1832 1827 -171 0 2909 2910 -19 8 2913 2914 -53 0 2909 2910 9 -10 0 2909 2910 -14 8 2921 2922 2911 2912 2923 2924 1834 11 19 -16 11 1835 2919 2920 15 -11 0 10 -8 11 2929 2930 2936 -23 0 1837 1839 1841 -24 11 19 -24 11 19 -2 11 1835 1836 1831 1832 1827 -6 0 1826 9 -57 0 2909 2910 2921 2922 2911 2912 2923 2924 1834 -10 11 1835 2919 2920 15 -23 0 10 -7 11 19 -7 11 19 -24 11 19 -37 11 19 -20 11 1835 1836 1831 3139 3140 -166 0 7 2921 2922 2911 2912 3990 14 3988 3989 14 -2 3990 -12 14 2915 2916 3139 3140 -47 0 2909 2910 2921 2922 2911 2912 15 -7 0 7 2921 2922 2911 2912 -6 14 3988 14 3989 -5 14 2923 2924 1834 -2 11 19 -22 11 12 -11 0 16 2925 2926 -4 11 2929 2930 2931 -24 0 1837 1839 1841 -55 11 1835 1836 1831 2917 2918 -2 8 2921 2922 1830 15 -23 0 2909 2910 -30 8 2921 2922 2911 2912 2923 2924 1834 -17 11 12 -23 0 10 -14 11 19 -5 11 19 -67 11 19 -12 11 1835 3143 3144 1838 -165 0 13 2923 2924 1834 -3 11 19 -17 11 1835 3143 3144 1838 -34 0 2909 2910 -8 8 2921 2922 2911 2912 2923 2924 1834 11 12 -7 0 13 2923 2924 1834 -42 11 19 12 -13 0 2928 17 3991 17 3991 2931 -25 0 1843 1839 1841 -15 11 19 -42 11 1835 2919 2920 3990 14 2923 2924 1834 12 -20 0 7 2921 2922 2911 2912 -2 14 3990 -15 14 3990 -9 14 3989 14 2923 2924 1834 -21 11 21 2913 2914 -21 0 10 -15 11 19 -2 11 19 -48 11 19 -2 11 19 -32 11 3147 1840 3149 -164 0 10 -26 11 3147 1840 1844 -30 0 7 2921 2922 2911 2912 3990 -7 14 2923 2924 1834 -5 11 12 -7 0 10 -26 11 19 -19 11 12 -44 0 1845 1841 -28 11 19 -3 11 19 -19 11 -2 19 -6 11 19 -6 11 12 -20 0 13 2923 2924 1834 -11 11 19 -15 11 19 -27 11 20 2915 2916 3139 3140 -19 0 10 -34 11 19 -45 11 19 -17 11 19 -5 11 1842 3151 3152 -45 0 78 83 78 -6 0 78 102 78 -42 0 2909 2910 2913 2914 -58 0 2909 2910 22 -4 11 19 -22 11 1842 1846 -30 0 13 2923 2924 1834 -17 11 12 -7 0 10 -44 11 19 11 12 -43 0 1837 1847 -52 11 19 -15 11 12 -20 0 10 -60 11 1835 3143 3144 3149 -16 0 2909 2910 22 -40 11 19 -26 11 19 -33 11 19 -3 11 3155 3156 1832 1827 -65 0 78 105 78 -2 0 78 -2 83 78 -2 0 78 83 78 -14 0 2909 2910 2921 2922 2911 2912 2915 2916 2917 2918 9 -51 0 2909 2910 2921 2922 2911 2912 23 -28 11 1848 1838 -29 0 10 -19 11 2940 18 -7 0 16 2937 -45 11 21 -10 8 2913 2914 -30 0 3150 1839 1849 19 -28 11 19 -26 11 19 -11 11 12 -20 0 10 -50 11 19 -11 11 3147 3151 3152 -4 0 2909 2910 -7 8 2921 2922 2911 2912 23 -27 11 19 -23 11 19 -17 11 19 -19 11 19 -16 11 1835 1836 1831 1832 1827 -87 0 2909 2910 2921 2922 2911 2912 2923 2924 1834 -2 11 1835 2919 2920 15 -48 0 7 2921 2922 2911 2912 2923 2924 1834 -30 11 1850 1840 1838 -28 0 10 -19 11 2941 -9 0 2938 -45 11 20 -10 14 2915 2916 2917 2918 -2 8 2913 2914 -23 0 3153 3154 1841 -4 11 19 -53 11 19 -10 11 12 -20 0 10 -36 11 19 -22 11 19 -3 11 3155 3156 2917 2918 2921 2922 2911 2912 3990 14 3990 -4 14 2923 2924 1834 -6 11 19 -10 11 19 -11 11 19 -77 11 19 -2 11 1835 1836 1831 1832 1827 -6 0 1826 9 -27 0 2909 2910 -16 8 2913 2914 -26 0 2909 2910 2921 2922 2911 2912 2923 2924 1834 -9 11 12 -48 0 13 2923 2924 1834 -23 11 19 -11 11 1842 1840 1838 -27 0 10 -2 11 19 -15 11 2940 2942 -9 0 2939 2937 -30 11 19 -14 11 19 -10 11 1835 2919 2920 -2 14 2915 2916 2917 2918 2913 2914 -8 0 2909 2910 9 -5 0 7 2921 2922 3157 3158 -70 11 12 -20 0 10 -58 11 19 -5 11 1835 2919 2920 2923 2924 1834 -17 11 19 -24 11 19 -65 11 19 -4 11 19 -9 11 1835 1836 1831 2917 2918 -2 8 2921 2922 1830 15 -23 0 2909 2910 2921 2922 2911 2912 -4 14 -2 3990 -2 14 3989 -2 14 3989 -4 14 2915 2916 2917 2918 9 -20 0 7 2921 2922 2911 2912 2923 2924 1834 -4 11 19 -8 11 21 2913 2914 -46 0 10 -7 11 19 -3 11 19 -21 11 19 -5 11 1842 1840 1838 -26 0 10 -4 11 19 -13 11 2941 -11 0 2938 -19 11 19 -42 11 1835 2919 2920 2915 2916 2917 2918 -4 8 2921 2922 2911 2912 15 -5 0 13 2923 2924 1834 -29 11 19 -41 11 12 -20 0 10 -24 11 19 -170 11 1835 2919 2920 3990 14 2923 2924 1834 12 -20 0 7 2921 2922 2911 2912 2923 2924 1834 -8 11 19 -9 11 1835 2919 2920 15 1551 1543 1544 -14 1540 1543 1544 1541 13 2923 2924 1834 -17 11 20 2915 2916 2917 2918 2913 2914 -40 0 2909 2910 22 -26 11 19 -13 11 1842 1840 1838 -25 0 10 -11 11 19 11 19 -3 11 2940 2942 -11 0 2939 2937 -4 11 19 -6 11 19 -7 11 19 -22 11 19 -22 11 1835 2919 2920 14 3989 -2 14 2923 2924 1834 11 12 -5 0 10 -5 11 19 -68 11 12 -20 0 10 -2 11 19 -10 11 19 -19 11 -2 19 -43 11 19 -103 11 19 -13 11 19 -6 11 12 -20 0 13 2923 2924 1834 -5 11 19 -19 11 12 1551 1547 1548 -14 1540 1547 1548 1541 10 -20 11 19 11 1835 2919 2920 2915 2916 2917 2918 -5 8 2913 2914 -26 0 2909 2910 8 2921 2922 2911 2912 23 -3 11 19 -16 11 19 -20 11 1842 1840 1838 -24 0 10 -17 11 2941 -13 0 2938 -3 11 19 -72 11 12 -5 0 10 -25 11 19 -48 11 12 -20 0 10 -42 11 19 -28 11 19 -106 11 19 -9 11 19 -14 11 12 -20 0 10 -28 11 12 0 2087 2088 -14 0 2087 2088 0 10 -26 11 1835 2919 2920 -5 14 2915 2916 2917 2918 9 -20 0 7 2921 2922 2911 2912 3989 2923 2924 1834 -44 11 1842 1840 3149 -9 0 2909 2910 9 -11 0 10 -16 11 2940 2942 -13 0 2939 2937 -36 11 19 -13 11 19 -18 11 19 -5 11 12 -5 0 10 -69 11 19 -4 11 12 -20 0 10 -101 11 19 -18 11 19 -5 11 19 -64 11 19 -11 11 12 -20 0 10 -9 11 19 -18 11 12 0 2087 2088 -14 0 2087 2088 0 10 -9 11 19 -22 11 19 -2 11 1835 2919 2920 15 1551 1543 1544 -14 1540 1543 1544 1541 13 2923 2924 1834 -50 11 1842 3151 3152 -4 0 2909 2910 2921 2922 2911 2912 15 -11 0 10 -16 11 2941 -15 0 2938 -66 11 19 -8 11 12 -5 0 10 -74 11 12 -20 0 10 -43 11 19 -140 11 19 -18 11 12 -20 0 16 2937 -27 11 12 0 2087 2088 -14 0 2087 2088 0 10 -13 11 19 -24 11 12 1551 1547 1548 -14 1540 1547 1548 1541 10 -54 11 3155 3156 2917 2918 2921 2922 2911 2912 2923 2924 1834 11 12 -4 0 7 -3 8 9 -2 0 10 -15 11 2940 2942 -15 0 2939 2937 -74 11 12 -5 0 10 -72 11 19 11 12 -20 0 10 -66 11 19 -127 11 19 -6 11 19 11 12 -21 0 2938 -24 11 19 -2 11 12 0 2087 2088 -14 0 2087 2088 0 10 11 19 -21 11 19 11 19 -3 11 19 -4 11 19 -3 11 12 0 2087 2088 -14 0 2087 2088 0 10 -55 11 1835 2919 2920 2923 2924 1834 -5 11 12 -4 0 13 -3 14 15 -2 0 10 -15 11 2941 -17 0 2938 19 -22 11 19 -17 11 19 -32 11 12 -5 0 10 -74 11 12 -20 0 10 -35 11 19 -16 11 19 -22 11 19 -6 11 19 -35 11 19 -40 11 19 -43 11 12 -21 0 2939 2937 -26 11 12 0 2087 2088 -14 0 2087 2088 0 10 -38 11 12 0 2087 2088 -14 0 2087 2088 0 10 11 19 -8 11 19 -55 11 12 -4 0 10 -3 11 21 -2 8 22 -14 11 2940 2942 -17 0 2939 2937 -7 11 19 -14 11 19 -24 11 19 11 19 -23 11 12 -5 0 10 -52 11 19 -21 11 12 -20 0 10 -42 11 19 -21 11 19 -45 11 19 -66 11 19 -25 11 12 -22 0 2938 -26 11 12 0 2087 2088 -14 0 2087 2088 0 10 -38 11 12 0 2087 2088 -14 0 2087 2088 0 10 -17 11 19 -42 11 19 -5 11 12 -4 0 10 -3 11 20 14 3988 23 -4 11 19 -9 11 2941 -19 0 2938 -5 11 19 -29 11 19 -37 11 12 -5 0 10 -74 11 12 -20 0 10 -85 11 19 -19 11 19 -30 11 19 -7 11 19 -6 11 -2 19 -16 11)
    )
    (tilemap
      (solid #t)
      (z-pos 1)
      (width 625)
      (height 65)
      (tiles -18514 0 -2 44 -8 0 -2 44 -612 0 44 -2 0 44 0 78 102 78 -2 0 44 -2 0 44 -767 0 -2 44 -622 0 44 -2 0 44 -546 0 -3 44 -6 0 -3 44 -612 0 44 -3 0 44 -4 0 44 -3 0 44 -2488 0 44 -8 0 44 -26 0 -2 44 -586 0 44 0 44 -6 0 44 0 44 -24 0 44 -2 0 44 -1046 0 -3 44 -621 0 44 -3 0 44 -509 0 -2 44 -9 0 -2 44 -107 0 -2 83 -501 0 -2 44 -2 0 -2 44 -5 0 -2 44 -2 0 -2 44 -607 0 44 -6 0 44 -3 0 44 -6 0 44 -946 0 -2 44 -622 0 44 -2 0 44 -372 0 -4 44 -244 0 44 -4 0 44 -967 0 -4 44 -442 0 -2 44 -622 0 44 -2 0 44 -896 0 -4 83 -1612 0 44 0 44 -3 0 44 0 -2 44 0 44 -3 0 44 0 44 -1917 0 -2 44 0 44 -2 0 44 0 -2 44 0 44 -2 0 44 0 -2 44 -3586 0)
    )
  )
)
