(supertux-level
  (version 3)
  (name (_ "Jumpy Jumpys"))
  (author "Sophie Ball")
  (note (_ "Act 2"))
  (license "CC-BY-SA 4.0 International")
  (target-time 97)
  (allow-item-pocket "inherit")
  (icon "")
  (icon-locked "")
  (statistics
    (enable-coins #t)
    (enable-badguys #f)
    (enable-secrets #t)
  )
  (sector
    (name "main")
    (ambient-light
      (color 1 0.9 1)
    )
    (background
      (color 1 1 1)
      (alignment "bottom")
      (speed 0.2)
      (image "images/background/antarctic/arctis2.png")
    )
    (background
      (color 1 1 1)
      (speed 0)
      (image "/images/background/antarctic/SnowMountainsSky.png")
      (z-pos -301)
    )
    (camera
      (name "Camera")
      (mode "normal")
    )
    (dispenser
      (z-pos 55)
      (cycle 2.5)
      (type "cannon")
      (objects
        (mrbomb
          (z-pos 50)
        )
      )
      (direction "left")
      (limit-dispensed-badguys #t)
      (max-concurrent-badguys 1)
      (x 5088)
      (y 1376)
    )
    (firefly
      (z-pos 0)
      (x 6496)
      (y 1312)
    )
    (flyingsnowball
      (z-pos 50)
      (x 8768)
      (y 992)
    )
    (flyingsnowball
      (z-pos 50)
      (x 9856)
      (y 992)
    )
    (jumpy
      (z-pos 50)
      (x 1728)
      (y 1536)
    )
    (jumpy
      (z-pos 50)
      (x 352)
      (y 1760)
    )
    (jumpy
      (z-pos 50)
      (x 2624)
      (y 1344)
    )
    (jumpy
      (z-pos 50)
      (x 2464)
      (y 1376)
    )
    (jumpy
      (z-pos 50)
      (x 2304)
      (y 1408)
    )
    (jumpy
      (z-pos 50)
      (x 2784)
      (y 1312)
    )
    (jumpy
      (z-pos 50)
      (x 3520)
      (y 1312)
    )
    (jumpy
      (z-pos 50)
      (x 5728)
      (y 1760)
    )
    (jumpy
      (z-pos 50)
      (x 5184)
      (y 1760)
    )
    (jumpy
      (z-pos 50)
      (x 4880)
      (y 1408)
    )
    (jumpy
      (z-pos 50)
      (x 7328)
      (y 1280)
    )
    (jumpy
      (z-pos 50)
      (x 7616)
      (y 1088)
    )
    (music
      (file "/music/present/midday.music")
    )
    (particles-snow
    )
    (powerup
      (version 2)
      (type "oneup")
      (z-pos 50)
      (disable-physics #t)
      (x 5280)
      (y 1632)
    )
    (secretarea
      (message (_ "You found the Tux Doll!"))
      (width 32)
      (height 32)
      (x 5280)
      (y 1632)
    )
    (sequencetrigger
      (sequence "endsequence")
      (width 32)
      (height 1216)
      (x 11296)
      (y 0)
    )
    (smartball
      (z-pos 50)
      (x 8512)
      (y 992)
    )
    (smartblock
      (z-pos 50)
      (x 8320)
      (y 992)
    )
    (smartblock
      (z-pos 50)
      (x 9504)
      (y 992)
    )
    (smartblock
      (z-pos 50)
      (x 9248)
      (y 992)
    )
    (smartblock
      (z-pos 50)
      (x 10592)
      (y 992)
    )
    (smartblock
      (z-pos 50)
      (x 10336)
      (y 992)
    )
    (snowball
      (z-pos 50)
      (x 1504)
      (y 1728)
    )
    (snowball
      (z-pos 50)
      (x 1440)
      (y 1728)
    )
    (snowball
      (z-pos 50)
      (x 4608)
      (y 1408)
    )
    (snowball
      (z-pos 50)
      (x 4480)
      (y 1440)
    )
    (snowball
      (z-pos 50)
      (x 4352)
      (y 1472)
    )
    (snowball
      (z-pos 50)
      (x 7264)
      (y 1344)
    )
    (snowball
      (z-pos 50)
      (x 7136)
      (y 1376)
    )
    (snowball
      (z-pos 50)
      (x 9376)
      (y 992)
    )
    (snowball
      (z-pos 50)
      (x 10464)
      (y 992)
    )
    (spawnpoint
      (name "main")
      (x 64)
      (y 1760)
    )
    (spawnpoint
      (x 5312)
      (y 1760)
    )
    (spawnpoint
      (x 4704)
      (y 1376)
    )
    (spawnpoint
      (x 5984)
      (y 1376)
    )
    (spawnpoint
      (x 6688)
      (y 1376)
    )
    (spawnpoint
      (x 5024)
      (y 1760)
    )
    (spiky
      (z-pos 50)
      (x 3328)
      (y 1376)
    )
    (spiky
      (z-pos 50)
      (x 4224)
      (y 1472)
    )
    (tilemap
      (solid #f)
      (z-pos -100)
      (width 400)
      (height 65)
      (tiles -12352 0 130 -399 0 129 -399 0 129 -399 0 129 -399 0 129 -399 0 129 -399 0 129 -399 0 129 -10847 0)
    )
    (tilemap
      (solid #f)
      (z-pos 100)
      (width 400)
      (height 65)
      (tiles -12354 0 130 -399 0 129 -399 0 129 -399 0 129 -399 0 129 -399 0 129 -399 0 129 -399 0 129 -10845 0)
    )
    (tilemap
      (solid #t)
      (z-pos 0)
      (width 400)
      (height 65)
      (tiles -157 0 10 -10 11 12 -19 0 10 -38 11 12 -329 0 10 -8 11 19 11 12 -19 0 10 -33 11 19 -4 11 12 -329 0 10 -10 11 12 -19 0 10 -38 11 12 -329 0 10 -10 11 12 -19 0 10 -27 11 19 -10 11 12 -329 0 10 -10 11 12 -19 0 10 -38 11 12 -329 0 10 -10 11 12 -19 0 10 -12 11 19 -2 11 19 -22 11 12 -329 0 10 19 -9 11 12 -19 0 10 -38 11 12 -329 0 10 -10 11 12 -19 0 10 -38 11 12 -329 0 10 -10 11 12 -19 0 10 -15 11 19 -22 11 12 -329 0 10 -10 11 12 -19 0 10 -30 11 19 -7 11 12 -329 0 10 -10 11 12 -19 0 10 -38 11 12 -329 0 10 -8 11 19 11 12 -19 0 10 -38 11 12 -329 0 10 -5 11 19 -4 11 12 -19 0 10 -38 11 12 -329 0 10 -10 11 12 -19 0 10 -38 11 12 -329 0 10 -10 11 12 -19 0 10 -2 11 19 -35 11 12 -329 0 10 19 -9 11 12 -19 0 10 -38 11 12 -329 0 10 -10 11 12 -19 0 10 -33 11 19 -4 11 12 -329 0 10 -10 11 12 -19 0 10 -12 11 19 -6 11 19 -18 11 12 -329 0 10 -10 11 12 -19 0 10 -20 11 19 -17 11 12 -329 0 10 -10 11 12 -19 0 10 -2 11 19 -20 11 19 -5 11 19 -8 11 12 -329 0 10 -10 11 12 -19 0 16 31 -37 11 12 -329 0 10 -10 11 12 -20 0 10 -37 11 12 -329 0 10 19 -9 11 12 -20 0 10 -24 11 19 -8 11 19 -3 11 12 -329 0 10 -10 11 12 -20 0 10 -37 11 12 -329 0 10 -10 11 12 -20 0 10 -37 11 12 -20 0 -2 44 0 -3 44 0 -3 44 0 -2 44 -29 0 -3 44 -31 0 -3 44 -230 0 10 -10 11 12 -20 0 16 31 -11 11 19 -24 11 12 -329 0 16 31 -6 11 19 -2 11 12 -21 0 10 -18 11 19 -17 11 12 -330 0 10 -9 11 12 -21 0 10 -11 11 19 -24 11 12 -330 0 10 -8 11 30 18 -21 0 10 -5 11 19 -30 11 12 -18 0 78 -4 83 78 0 78 102 78 0 78 -4 83 78 -26 0 78 -3 83 78 -29 0 78 -3 83 78 -230 0 10 -8 11 12 -22 0 10 -31 11 19 -4 11 12 -330 0 10 -8 11 12 -22 0 10 -32 11 19 -3 11 12 -330 0 10 -8 11 12 -22 0 10 -35 11 2940 18 -16 0 2909 2910 -18 8 2913 2914 -17 0 2909 2910 -13 8 2913 2914 -17 0 2909 2910 -13 8 2913 2914 -224 0 10 -8 11 12 -22 0 10 -35 11 2941 -15 0 3141 3142 2911 2912 3990 -2 14 3990 -3 14 3990 14 3989 -5 14 3990 -2 14 2915 2916 2917 2918 9 -11 0 7 2921 2922 2911 2912 -5 14 -2 3990 -3 14 3990 -2 14 2915 2916 2917 2918 9 -11 0 7 2921 2922 2911 2912 -5 14 -2 3990 -3 14 3990 -2 14 2915 2916 2917 2918 9 -221 0 16 31 -7 11 12 -22 0 16 31 -33 11 2940 2942 -14 0 3150 3145 3146 1834 -20 11 1835 2919 2920 15 -11 0 13 2923 2924 1834 -3 11 19 -11 11 1835 2919 2920 15 -11 0 13 2923 2924 1834 -9 11 19 11 19 -3 11 1835 2919 2920 15 -222 0 10 -4 11 19 11 30 18 -23 0 10 -33 11 2941 -14 0 3153 3154 3148 -6 11 19 -13 11 19 -4 11 12 -11 0 10 -4 11 19 -16 11 12 -11 0 10 -21 11 12 -222 0 10 -2 19 -4 11 12 -24 0 10 -9 11 19 -12 11 19 -9 11 30 2942 -11 0 7 2921 2922 3157 3158 -2 11 19 -23 11 12 -11 0 10 -21 11 12 -11 0 10 -21 11 12 -222 0 10 -6 11 12 -24 0 10 -18 11 19 -13 11 12 -12 0 13 2923 2924 1834 -27 11 12 -11 0 10 -11 11 19 -9 11 12 -11 0 10 -21 11 21 2913 2914 -220 0 10 -6 11 12 -24 0 10 -32 11 12 -10 0 2909 2910 22 -29 11 19 12 -11 0 10 -20 11 19 12 -11 0 10 -21 11 20 2915 2916 2917 2918 -59 8 -159 0 10 -6 11 12 -24 0 16 2933 -19 11 19 -10 11 2935 18 -8 0 3141 3142 2911 2912 23 -30 11 12 -11 0 10 -3 11 19 -17 11 12 -11 0 10 -23 11 1835 2919 2920 -5 14 -2 3990 -15 14 3989 -6 14 3989 -2 14 3990 -7 14 3990 14 3990 -6 14 -2 3990 -8 14 -159 0 16 31 -5 11 12 -25 0 2934 2925 2926 -26 11 2929 2930 2936 -8 0 3150 3145 3146 1834 -2 11 19 -14 11 19 -14 11 12 -11 0 10 -21 11 12 -11 0 10 -43 11 19 -4 11 19 -36 11 -160 0 10 -4 11 30 18 -27 0 2928 -2 17 3991 -7 17 3991 -11 17 -2 3991 -2 17 2931 -9 0 3153 3154 3148 -34 11 12 -11 0 10 11 19 -19 11 12 -11 0 10 11 19 -42 11 19 -25 11 19 -6 11 19 -7 11 -160 0 10 -4 11 12 -62 0 7 2921 2922 3157 3158 -35 11 12 -11 0 10 -7 11 19 -13 11 12 -11 0 10 -50 11 19 -28 11 19 -5 11 -65 0 2909 2910 -4 8 9 0 7 -2 8 9 0 7 -2 8 9 0 7 -7 8 9 -14 0 7 -7 8 2913 2914 -44 0 10 -2 11 19 11 12 -60 0 2909 2910 114 2923 2924 1834 -5 11 19 -30 11 12 -11 0 10 -21 11 12 -11 0 10 -19 11 19 -24 11 19 -39 11 19 -62 0 7 2921 2922 2911 2912 -4 14 15 0 13 3990 14 15 0 13 -2 14 113 8 114 14 3990 -5 14 113 -14 8 114 -4 14 3990 14 3989 2915 2916 2917 2918 2913 2914 -25 0 202 -14 0 10 -4 11 12 -29 0 2909 2910 -27 8 2921 2922 2911 2912 23 -18 11 19 -14 11 19 -5 11 12 -11 0 10 -21 11 12 -11 0 10 -5 11 19 11 19 -77 11 -62 0 13 2923 2924 1834 -5 11 12 0 10 -2 11 21 8 22 -2 11 20 14 23 -7 11 20 14 3990 -12 14 23 -4 11 19 -3 11 1835 2919 2920 2915 2916 2917 2918 2913 2914 -19 0 2909 2910 204 2913 2914 -10 0 2909 2910 22 -4 11 12 -26 0 7 2921 2922 2911 2912 -8 14 3990 -4 14 3990 -6 14 3990 -5 14 3990 2923 2924 1834 -34 11 19 -6 11 12 -11 0 10 -21 11 12 -11 0 10 -33 11 19 -16 11 19 -21 11 19 -5 11 19 -6 11 -62 0 10 -8 11 21 8 22 -2 11 20 14 23 -40 11 1835 2919 2920 2915 2916 2917 2918 8 2913 2914 -10 0 2909 2910 2921 2922 2911 2912 214 2915 2916 2917 2918 9 -4 0 7 2921 2922 2911 2912 23 -4 11 12 -26 0 13 2923 2924 1834 -26 11 19 -21 11 19 -23 11 12 -11 0 10 -21 11 12 -11 0 10 -15 11 19 -62 11 19 -6 11 -62 0 10 -8 11 20 14 23 -23 11 19 -25 11 1835 2919 2920 14 2915 2916 2917 2918 -6 8 2921 2922 2911 2912 2923 2924 1834 -3 11 1835 2919 2920 15 -4 0 13 2923 2924 1834 -6 11 12 -26 0 10 -74 11 19 12 -11 0 10 -20 11 19 12 -11 0 10 -13 11 19 -52 11 19 -10 11 19 -2 11 19 -4 11 -60 0 2909 2910 22 -65 11 1835 2919 2920 3990 -4 14 3990 2923 2924 1834 11 -2 19 -7 11 12 -4 0 10 -9 11 12 -26 0 10 -75 11 12 -11 0 10 -5 11 19 -15 11 12 -11 0 10 -37 11 19 -34 11 19 -12 11 -56 0 2909 2910 2921 2922 2911 2912 23 -32 11 19 -14 11 19 -25 11 19 -10 11 19 -2 11 12 -4 0 10 -9 11 12 -26 0 10 -35 11 19 -35 11 19 -3 11 12 -11 0 10 -17 11 19 -3 11 12 -11 0 10 -79 11 19 -5 11 -53 0 7 2921 2922 2911 2912 2923 2924 1834 -20 11 19 -68 11 12 -4 0 10 -9 11 12 -26 0 10 -70 11 19 -4 11 12 -11 0 10 -21 11 12 -11 0 10 11 19 -18 11 19 -17 11 19 -46 11 -53 0 13 2923 2924 1834 -29 11 19 -19 11 19 -43 11 12 -4 0 10 -4 11 2929 2930 3991 2933 11 12 -26 0 10 -45 11 19 -29 11 12 -11 0 10 -7 11 19 -13 11 12 -11 0 10 -85 11 -53 0 10 -96 11 12 -4 0 16 17 3991 -2 17 2931 -2 0 2934 3991 18 -26 0 10 -47 11 19 -8 11 19 -13 11 19 -4 11 12 -11 0 10 -10 11 19 -10 11 12 -11 0 10 -12 11 -2 19 -66 11 19 -3 11 19 -16 0 78 83 78 0 83 102 0 78 83 78 -27 0 10 -96 11 12 -41 0 10 -5 11 19 -8 11 19 11 19 -13 11 19 -42 11 19 11 12 -11 0 10 -19 11 19 11 12 -11 0 10 -27 11 19 -31 11 19 -3 11 19 -21 11 -51 0 2909 2910 22 -27 11 -2 19 -43 11 19 -23 11 12 -41 0 10 -75 11 12 -11 0 10 -21 11 12 -11 0 10 -54 11 19 -25 11 19 -4 11 -45 0 2909 2910 -2 8 2921 2922 2911 2912 23 -32 11 19 -9 11 19 -18 11 19 -34 11 12 -41 0 10 -45 11 -2 19 -17 11 19 -10 11 12 -11 0 10 -21 11 12 -11 0 10 -19 11 19 -30 11 19 -9 11 19 -24 11 -14 0 2909 2910 -10 8 2913 2914 -9 0 2909 2910 -4 8 2921 2922 2911 2912 -2 14 2923 2924 1834 -79 11 19 -18 11 12 -41 0 10 -21 11 19 -17 11 19 -22 11 19 -12 11 12 -11 0 10 -21 11 12 -11 0 10 -85 11 -12 8 2921 2922 2911 2912 -10 14 2915 2916 2917 2918 -5 8 2921 2922 2911 2912 -4 14 2923 2924 1834 -104 11 21 -14 8 9 -12 0 -3 44 -11 0 10 -5 11 19 -58 11 19 -10 11 12 -11 0 10 -16 11 -2 19 -3 11 12 -11 0 10 19 -16 11 19 -59 11 19 -7 11 -3 14 3990 -8 14 2923 2924 1834 -12 11 1835 2919 2920 14 3990 -3 14 2923 2924 1834 -33 11 19 -78 11 20 -14 14 15 -26 0 10 -75 11 12 -11 0 10 -21 11 12 -11 0 10 -29 11 19 -22 11 19 -45 11 19 -24 11 19 -25 11 19 -61 11 19 -38 11 12 -26 0 10 -46 11 19 11 19 -26 11 12 -11 0 10 -21 11 12 -11 0 10 -15 11 19 -78 11 19 -9 11 19 -111 11 19 -8 11 19 -24 11 12 -26 0 10 -29 11 19 -45 11 12 -11 0 10 -21 11 12 -11 0 10 -56 11 19 -50 11 19 -23 11 19 -18 11 19 -19 11 19 -8 11 19 11 19 -18 11 19 -22 11 19 -26 11 12 -26 0 10 -30 11 19 -6 11 19 -19 11 19 -17 11 12 -11 0 10 -21 11 12 -11 0 10 -100 11 19 -35 11 19 -42 11 19 -24 11 19 -28 11 19 -2 11 19 -13 11 12 -26 0 10 -75 11 12 -11 0 10 -21 11 12 -11 0 10 -38 11 19 -5 11 19 -65 11 19 -6 11 19 -48 11 19 -25 11 19 -21 11 19 11 19 -3 11 19 -4 11 19 -24 11 12 -26 0 10 -75 11 12 -11 0 10 -21 11 12 -11 0 10 -44 11 19 -14 11 19 -71 11 19 -4 11 19 -113 11 12 -26 0 10 -57 11 19 -17 11 12 -11 0 10 -21 11 12 -11 0 10 -21 11 30 -11 17 3991 17 3991 17 3991 -2 17 3991 -7 17 3991 -7 17 3991 -2 17 3991 -3 17 -2 3991 -7 17 3991 -5 17 3991 17 3991 -4 17 -8 11 19 -106 11 30 -5 17 31 -42 11 19 12 -26 0 10 -33 11 19 -16 11 19 -24 11 12 -11 0 10 -21 11 12 -11 0 10 -21 11 12 -63 0)
    )
    (tilemap
      (solid #t)
      (z-pos 1)
      (width 400)
      (height 65)
      (tiles -15671 0 -3 44 -2 0 -3 44 -15 0 -4 44 -2 0 -4 44 -497 0 1551 -3 1540 1541 -326 0 -4 44 -345 0 -3 44 -2 0 -3 44 -20 0 -3 44 -19 0 44 -4 0 44 -367 0 44 -25 0 44 -6 0 44 -1213 0 44 0 44 -398 0 44 0 44 -264 0 44 -2 0 44 -128 0 44 0 44 -264 0 44 0 -2 44 0 44 -1741 0 44 -398 0 44 -400 0 44 -395 0 -4 44 -3435 0)
    )
    (trampoline
      (type "stationary")
      (z-pos -1)
      (x 4928)
      (y 1792)
    )
    (trampoline
      (type "stationary")
      (z-pos -1)
      (x 4896)
      (y 1792)
    )
    (trampoline
      (type "stationary")
      (z-pos -1)
      (x 4864)
      (y 1792)
    )
    (trampoline
      (type "stationary")
      (z-pos -1)
      (x 4832)
      (y 1792)
    )
    (unstable_tile
      (z-pos 0)
      (x 5312)
      (y 1824)
    )
    (unstable_tile
      (z-pos 0)
      (x 5344)
      (y 1824)
    )
    (unstable_tile
      (z-pos 0)
      (x 5376)
      (y 1824)
    )
    (unstable_tile
      (z-pos 0)
      (x 5408)
      (y 1824)
    )
    (unstable_tile
      (z-pos 0)
      (x 5440)
      (y 1824)
    )
    (unstable_tile
      (z-pos 0)
      (x 5472)
      (y 1824)
    )
    (unstable_tile
      (z-pos 0)
      (x 5504)
      (y 1824)
    )
    (unstable_tile
      (z-pos 0)
      (x 5536)
      (y 1824)
    )
    (unstable_tile
      (z-pos 0)
      (x 5568)
      (y 1824)
    )
    (unstable_tile
      (z-pos 0)
      (x 5600)
      (y 1824)
    )
    (unstable_tile
      (z-pos 0)
      (x 5632)
      (y 1824)
    )
    (unstable_tile
      (z-pos 0)
      (x 5664)
      (y 1824)
    )
    (unstable_tile
      (z-pos 0)
      (x 5696)
      (y 1824)
    )
    (unstable_tile
      (z-pos 0)
      (x 5728)
      (y 1824)
    )
    (unstable_tile
      (z-pos 0)
      (x 5760)
      (y 1824)
    )
    (unstable_tile
      (z-pos 0)
      (x 5792)
      (y 1824)
    )
    (unstable_tile
      (z-pos 0)
      (x 5824)
      (y 1824)
    )
    (unstable_tile
      (z-pos 0)
      (x 5856)
      (y 1696)
    )
    (unstable_tile
      (z-pos 0)
      (x 5920)
      (y 1696)
    )
    (unstable_tile
      (z-pos 0)
      (x 5888)
      (y 1696)
    )
    (unstable_tile
      (z-pos 0)
      (x 5824)
      (y 1568)
    )
    (unstable_tile
      (z-pos 0)
      (x 5792)
      (y 1568)
    )
    (unstable_tile
      (z-pos 0)
      (x 5760)
      (y 1568)
    )
    (unstable_tile
      (z-pos 0)
      (x 5728)
      (y 1568)
    )
    (unstable_tile
      (z-pos 0)
      (x 5696)
      (y 1568)
    )
    (unstable_tile
      (z-pos 0)
      (x 5664)
      (y 1568)
    )
    (unstable_tile
      (z-pos 0)
      (x 5632)
      (y 1568)
    )
    (unstable_tile
      (z-pos 0)
      (x 5600)
      (y 1568)
    )
    (unstable_tile
      (z-pos 0)
      (x 5568)
      (y 1568)
    )
    (unstable_tile
      (z-pos 0)
      (x 5536)
      (y 1568)
    )
    (unstable_tile
      (z-pos 0)
      (x 5504)
      (y 1568)
    )
    (unstable_tile
      (z-pos 0)
      (x 5472)
      (y 1568)
    )
    (unstable_tile
      (z-pos 0)
      (x 5440)
      (y 1568)
    )
    (unstable_tile
      (z-pos 0)
      (x 5408)
      (y 1568)
    )
    (unstable_tile
      (z-pos 0)
      (x 5376)
      (y 1568)
    )
    (unstable_tile
      (z-pos 0)
      (x 5344)
      (y 1568)
    )
    (unstable_tile
      (z-pos 0)
      (x 5312)
      (y 1568)
    )
    (unstable_tile
      (z-pos 0)
      (x 5440)
      (y 1440)
    )
    (unstable_tile
      (z-pos 0)
      (x 5408)
      (y 1440)
    )
    (unstable_tile
      (z-pos 0)
      (x 5472)
      (y 1440)
    )
    (unstable_tile
      (z-pos 0)
      (x 5504)
      (y 1440)
    )
    (unstable_tile
      (z-pos 0)
      (x 5536)
      (y 1408)
    )
    (unstable_tile
      (z-pos 0)
      (x 5568)
      (y 1376)
    )
    (unstable_tile
      (z-pos 0)
      (x 5600)
      (y 1344)
    )
    (unstable_tile
      (z-pos 0)
      (x 5632)
      (y 1344)
    )
    (unstable_tile
      (z-pos 0)
      (x 5664)
      (y 1344)
    )
    (unstable_tile
      (z-pos 0)
      (x 5696)
      (y 1344)
    )
    (unstable_tile
      (z-pos 0)
      (x 5728)
      (y 1344)
    )
    (unstable_tile
      (z-pos 0)
      (x 5760)
      (y 1344)
    )
    (unstable_tile
      (z-pos 0)
      (x 5792)
      (y 1344)
    )
    (unstable_tile
      (z-pos 0)
      (x 5856)
      (y 1376)
    )
    (unstable_tile
      (z-pos 0)
      (x 5824)
      (y 1344)
    )
    (unstable_tile
      (z-pos 0)
      (x 5888)
      (y 1408)
    )
    (unstable_tile
      (z-pos 0)
      (x 5920)
      (y 1440)
    )
    (unstable_tile
      (z-pos 0)
      (x 5952)
      (y 1440)
    )
    (unstable_tile
      (z-pos 0)
      (x 5984)
      (y 1440)
    )
    (unstable_tile
      (z-pos 0)
      (x 6016)
      (y 1440)
    )
    (unstable_tile
      (z-pos 0)
      (x 6048)
      (y 1440)
    )
    (unstable_tile
      (z-pos 0)
      (x 6080)
      (y 1440)
    )
    (unstable_tile
      (z-pos 0)
      (x 6112)
      (y 1440)
    )
    (weak_block
      (version 2)
      (z-pos 60)
      (x 4864)
      (y 1504)
    )
    (weak_block
      (version 2)
      (z-pos 60)
      (x 4832)
      (y 1504)
    )
    (weak_block
      (version 2)
      (z-pos 60)
      (x 4896)
      (y 1504)
    )
    (weak_block
      (version 2)
      (z-pos 60)
      (x 4928)
      (y 1504)
    )
    (weak_block
      (version 2)
      (z-pos 60)
      (x 4928)
      (y 1472)
    )
    (weak_block
      (version 2)
      (z-pos 60)
      (x 4896)
      (y 1472)
    )
    (weak_block
      (version 2)
      (z-pos 60)
      (x 4864)
      (y 1472)
    )
    (weak_block
      (version 2)
      (z-pos 60)
      (x 4832)
      (y 1472)
    )
    (weak_block
      (version 2)
      (z-pos 60)
      (x 4928)
      (y 1536)
    )
    (weak_block
      (version 2)
      (z-pos 60)
      (x 4896)
      (y 1536)
    )
    (weak_block
      (version 2)
      (z-pos 60)
      (x 4864)
      (y 1536)
    )
    (weak_block
      (version 2)
      (z-pos 60)
      (x 4832)
      (y 1536)
    )
    (weak_block
      (version 2)
      (z-pos 60)
      (x 5280)
      (y 1664)
    )
    (weak_block
      (version 2)
      (z-pos 60)
      (x 5280)
      (y 1696)
    )
    (weak_block
      (version 2)
      (z-pos 60)
      (x 5280)
      (y 1728)
    )
    (weak_block
      (version 2)
      (z-pos 60)
      (x 5280)
      (y 1760)
    )
    (weak_block
      (version 2)
      (z-pos 60)
      (x 5280)
      (y 1792)
    )
    (weak_block
      (version 2)
      (z-pos 60)
      (x 5248)
      (y 1792)
    )
    (weak_block
      (version 2)
      (z-pos 60)
      (x 5248)
      (y 1760)
    )
    (weak_block
      (version 2)
      (z-pos 60)
      (x 5248)
      (y 1728)
    )
    (weak_block
      (version 2)
      (z-pos 60)
      (x 5248)
      (y 1696)
    )
    (weak_block
      (version 2)
      (z-pos 60)
      (x 5248)
      (y 1664)
    )
    (weak_block
      (version 2)
      (z-pos 60)
      (x 5248)
      (y 1632)
    )
    (weak_block
      (version 2)
      (z-pos 60)
      (x 5312)
      (y 1632)
    )
    (weak_block
      (version 2)
      (z-pos 60)
      (x 5312)
      (y 1600)
    )
    (weak_block
      (version 2)
      (z-pos 60)
      (x 5312)
      (y 1664)
    )
  )
)
