(supertux-level
  (version 3)
  (name (_ "Yeti The Bully"))
  (author "Sophie Ball")
  (note (_ "Act Boss"))
  (license "CC-BY-SA 4.0 International")
  (allow-item-pocket "inherit")
  (icon "")
  (icon-locked "")
  (statistics
    (enable-coins #f)
    (enable-badguys #f)
    (enable-secrets #f)
  )
  (sector
    (name "main")
    (ambient-light
      (color 0.5 0.5 0.6)
    )
    (background
      (color 1 1 1 0.5)
      (scroll-speed-x -50)
      (speed 0.5)
      (image "/images/background/misc/fog.png")
      (z-pos 300)
    )
    (background
      (color 1 1 1 0.7)
      (speed 0)
      (fill #t)
      (image "/images/background/misc/vignette.png")
      (z-pos 301)
    )
    (camera
      (name "Camera")
      (mode "normal")
    )
    (gradient
      (top_color 0.07843138 0 0.9843137 0.1)
      (bottom_color 0 0 0 0.5)
      (z-pos 299)
    )
    (leveltime
      (time 80)
    )
    (music
      (file "/music/boss/yetiboss.music")
    )
    (spawnpoint
      (name "main")
      (x 640)
      (y 736)
    )
    (tilemap
      (solid #f)
      (z-pos -100)
      (width 40)
      (height 35)
      (tiles -601 0 106 107 108 -30 0 106 107 108 -4 0 109 110 111 -30 0 109 110 111 -302 0 25 -34 0 24 -10 0 24 -374 0)
    )
    (tilemap
      (solid #f)
      (z-pos 100)
      (width 40)
      (height 35)
      (tiles -1400 0)
    )
    (tilemap
      (solid #t)
      (z-pos 0)
      (width 40)
      (height 35)
      (tiles 19 -13 11 19 -12 11 19 -139 11 19 -83 11 19 -87 11 19 -100 11 -3 17 3991 17 3991 -2 17 3991 -8 17 -2 3991 -8 17 -3 3991 17 3991 -4 17 3991 -3 17 -160 0 -6 8 2913 2914 -24 0 2909 2910 -6 8 -6 14 2915 2916 2917 2918 9 -18 0 7 2921 2922 2911 2912 14 3989 -4 14 -2 11 19 -5 11 2919 2920 15 -18 0 13 2923 2924 1834 -17 11 12 -18 0 10 -20 11 12 -18 0 10 -3 11 19 -16 11 12 -18 0 10 -3 11 19 -15 11 2940 18 -18 0 16 2937 -18 11 2941 -20 0 2938 11 19 -10 11 19 -4 11 2940 2942 -7 0 2909 2910 -2 8 2913 2914 -7 0 2939 2937 -16 11 2941 -4 0 7 8 2921 2922 2911 2912 -2 14 2915 2916 2917 2918 8 9 -4 0 2938 -15 11 2935 2942 -4 0 13 3989 2923 2924 1834 -5 11 2919 2920 14 15 -4 0 2939 2933 -13 11 2940 2936 -5 0 10 -12 11 12 -5 0 2934 2937 -12 11 2941 -6 0 10 -12 11 12 -6 0 2938 -4 11 19 -6 11 2935 2942 -6 0 10 -5 11 19 -6 11 12 -6 0 2939 2933 -8 11 2929 2930 2936 -7 0 10 -8 11 19 -3 11 12 -7 0 2934 2925 2926 -5 11 2935 2931 -9 0 10 11 19 -10 11 12 -9 0 2928 2933 -3 11 2935 2936 -10 0 10 -11 11 19 12 -10 0 2934 2933 11 2940 2936 -11 0 10 -12 11 12 -11 0 2934 2937 2941 -12 0 10 -12 11 12 -12 0 2938)
    )
    (tilemap
      (solid #f)
      (z-pos -300)
      (width 40)
      (height 35)
      (tiles 2180 2187 2179 2187 2180 2197 2195 2187 2195 2179 2189 -2 2181 2187 2180 2179 2181 -2 2179 2189 2188 2196 2187 2179 2197 2188 2189 2180 2189 2188 2179 2188 2189 2188 2179 2188 -3 2187 2188 2180 2195 2180 2195 2188 2179 -2 2197 2179 2189 2179 2197 2179 2188 -2 2179 2189 2181 2188 -2 2179 2187 2195 2180 2188 2179 2181 2180 2195 2197 2196 2188 2195 2196 2195 2188 2197 2180 2188 2187 2181 2196 2181 2197 2189 2181 2180 2181 2189 2179 2195 2187 2196 2181 2179 2180 2196 2195 2179 2196 2179 2195 2197 2195 2179 2197 2181 2188 2180 2187 2196 2187 2180 2189 2195 2187 2188 2179 2187 2179 2188 2197 2188 2179 2196 -2 2187 2195 2179 2187 -2 2181 2187 2181 2180 2189 2179 2180 2195 2187 2179 2197 -2 2181 2196 2197 2187 -2 2197 2187 2197 2179 2197 2189 2197 2180 2181 2180 2179 2196 2189 2179 2187 2181 2179 2197 2179 2180 2187 2180 2179 2180 2187 -2 2188 2197 2195 2197 2189 2187 2180 2181 2197 2179 2196 -2 2179 2187 2196 2195 2188 2195 2197 2196 2189 2179 2188 2195 2196 2197 2187 2179 2196 2189 -2 2181 2188 2195 2180 -2 2197 2179 2195 2187 2196 -2 2181 2195 2189 2196 2187 2196 2187 2179 2197 2189 2187 2189 2197 -2 2179 2195 2179 -2 2181 2179 2196 2188 2197 2181 2187 2181 2197 2195 2187 2195 2197 2181 2197 2195 2196 2180 2196 2197 2180 2197 2179 -2 2187 -2 2179 2189 2187 2179 2181 2179 -2 2189 2181 2195 2197 2196 2189 2179 2181 -2 2189 2188 2180 2179 2195 2188 -4 2179 2188 2197 -2 2187 2196 2181 2179 2181 2196 2195 2179 2195 2197 2187 2195 2188 2187 2189 2196 2197 2189 -2 2196 2187 2179 -2 2180 2179 2187 2179 2189 2195 2197 2179 2196 2189 2188 2181 2188 2187 2179 2187 2188 2189 2196 2189 2188 2196 2188 2189 2179 2197 2181 2180 2189 2188 -2 2197 2187 2197 2196 2188 -2 2187 2188 2197 2180 2181 2180 2179 2195 2181 2196 2181 2197 2195 -2 2187 2196 2179 2187 -2 2181 2189 2179 2196 2197 2188 2180 2189 2179 2181 2196 2197 2189 2187 2181 2187 2189 2179 2180 2179 2187 2197 2179 2196 2188 2196 2179 2180 2181 2180 2179 2197 2179 2197 2196 2197 2180 2187 2181 2179 2180 2189 2180 2179 2188 -2 2179 2189 2188 2195 2189 2196 2187 2179 2197 2189 2187 2188 2197 2179 2197 2188 2196 2197 2196 2187 2180 2195 2179 2188 2187 2197 -3 2179 2181 2195 2180 -2 2179 2180 2195 2189 2187 2179 2197 2179 2195 2196 -2 2181 -2 2197 2189 2195 2189 2197 2179 2195 2180 2181 2180 2196 2181 -3 2187 2188 2180 2196 2189 -2 2179 2180 2188 2195 2180 2197 2195 2197 2180 2197 2196 2179 -2 2196 2180 2179 2181 2179 2181 2179 2188 2180 -2 2195 2188 -2 2196 2189 2179 2180 2179 2197 2189 2197 2181 2188 -4 2187 2180 2188 2195 2179 2195 -2 2189 2196 2181 2180 2181 2196 2187 2196 2188 2189 2179 2197 -2 2188 -2 2179 2196 -2 2179 2195 -2 2179 2196 2188 2195 2196 2195 2189 2180 2195 2180 2187 2179 2188 2181 2187 2179 2189 2181 2180 2188 2196 -2 2189 2196 -2 2189 2197 2195 2179 2195 2197 2195 2197 2195 -2 2179 2195 2179 2197 2189 -2 2197 2196 2188 2197 2180 2181 2188 2181 2180 2179 2196 2187 2188 2196 2181 2179 2197 2179 2181 2197 2196 2197 2188 2181 2189 2179 2180 2195 2187 -2 2179 -2 2187 2181 2187 2189 2179 -2 2180 2196 2181 -2 2188 2180 2197 2188 2196 2179 2188 2187 2196 2179 2189 2179 2187 -2 2189 2196 2181 -2 2179 2188 2179 2180 2187 2188 2195 2188 2195 2188 2187 2188 2195 2187 2180 2188 2180 2196 -2 2179 2196 2181 2195 -2 2196 2195 2189 2180 2197 2189 2179 2196 2189 2180 -2 2179 2180 2187 -2 2180 2188 2179 2197 2179 2196 2197 2188 2181 -2 2196 2180 2181 2197 -2 2179 2189 2195 2189 2179 -2 2189 2188 2179 2195 2179 2181 2189 2187 -3 2195 2196 2187 -2 2188 2189 2197 2188 2181 2188 2196 2187 2195 2180 2179 2188 2179 2188 2179 2181 2179 2188 2181 2196 2179 2196 2181 2189 2188 2179 2189 -2 2196 2195 2189 2180 2195 2181 2195 2180 2195 2180 2195 2187 2196 2179 2187 2181 2188 2195 -2 2181 2187 2181 2189 -2 2179 -2 2189 -2 2179 2187 2196 2195 2179 2181 2179 2187 -2 2197 2195 2181 2196 2179 2180 -2 2181 2180 -2 2179 2197 -2 2196 2197 2180 2187 -2 2181 2189 2179 2197 2179 -2 2187 2197 2195 2179 2195 2179 2196 -2 2179 2189 2195 2189 2197 2179 2197 2187 2197 -2 2179 2197 2187 2180 2187 2179 2188 2195 2179 2188 2196 2197 2179 2187 2180 2179 2181 2195 2188 2189 2197 2195 2197 2189 2187 -2 2179 2187 2195 2181 2189 2188 2196 2179 2195 2180 -2 2189 2180 2195 2179 2181 -2 2188 2181 2179 2197 2187 2188 2180 -2 2179 2188 2179 -2 2197 2181 -2 2197 2180 2196 2197 2181 2180 2189 2181 2187 2188 2196 2195 2180 2188 2180 2187 2196 2187 2180 2189 2195 2187 2188 2179 2188 2196 2179 2188 2187 2196 2179 2181 2187 2179 2187 -2 2189 2196 2181 2180 2188 2197 2196 2179 2196 2197 2189 2187 2180 2181 2179 2180 2179 2189 2195 2189 2179 2180 2179 2196 2181 2195 -2 2196 2195 2189 2181 2179 2187 2181 2179 2195 2189 2179 -2 2197 2180 2195 2188 2189 2197 2195 2197 -2 2188 2196 2187 2179 2197 -2 2181 2197 2179 2197 2181 2189 2181 2197 2180 2181 2180 2197 2189 2197 2181 2189 2195 2196 2197 2179 2180 2188 2195 -2 2180 2188 2197 -2 2187 2197 -2 2187 2179 2196 2179 2195 2197 2189 2195 2189 2196 2195 2180 2181 2179 2195 2197 2196 2189 2179 2181 2189 2188 2181 2179 2195 2181 2197 2189 2179 2195 2188 2180 2181 2189 2197 2187 2189 2196 2181 2180 2189 -2 2180 2196 2195 -2 2180 -2 2195 2188 2187 2188 -3 2179 2187 2197 2179 2197 2187 2180 2187 2197 2179 -2 2180 -2 2181 2188 2189 2195 2179 2188 2196 2188 2181 2189 2179 2196 2179 2189 2188 2196 2187 2197 2187 2197 2195 -2 2179 2195 2197 2195 2181 -2 2189 2180 2195 2179 2180 2179 2197 2195 2181 2197 2188 2197 2188 2179 2187 2181 2179 2188 2179 2197 2179 2189 2180 2181 2195 2189 2196 2188 2189 2179 2180 2196 2197 2187 -2 2197 2188 2195 2187 2180 2187 2195 2187 2181 2197 2181 2189 2195 -5 2196 2197 2179 2180 -2 2189 2188 2189 2197 -2 2189 2197 2187 2195 2180 2179 2189 2188 2196 2195 2180 2181 2197 -2 2180 2196 -2 2179 2197 2188 2195 2197 2196 2195 2188 2179 2189 2179 2189 2179 2189 2179 2187 2181 2180 2187 2195 2179 2195 2187 2197 2189 2188 2196 2187 2197 2187 2196 2189 2196 2187 -2 2179 2195 -2 2179 2195 2180 -2 2181 2179 2187 2179 2181 2188 -3 2189 -3 2188 2189 2187 2196 2180 2195 2179 2187 2189 2195 2180 2179 2188 2179 2180 2195 2196 2181 2188 2179 2180 2197 2181 2188 2179 2188 2189 2188 2179 2181 -2 2189 2181 2179 2195 2180 2195 2180 2187 2179 2187 2180 2196 2187 2189 2196 2188 2180 2188 2196 2187 2196 -2 2188 2196 2195 2179 2197 -2 2181 2196 2179 2195 2179 2180 2179 2189 -2 2196 2187 2180 2187 2197 2179 -4 2180 -3 2179 2180 2188 2195 2179 2197 2195 2196 2180 -2 2179 2187 2188 2195 2189 2195 2188 2187 2188 2195 2187 2179 2181 2179 2189 2195 2187 2181 2195 -2 2179 2197 2195 2188 2197 2188 2197 2181 2196 2181 2196 2189 2180 -2 2179 2197 2179 2188 2179 2180 2187 2188 2189 -2 2180 -2 2196 2188 2189 2180 2189 2188 2197 -2 2179 2187 2197 2179 2197 2187 2179 2189 2195 2196 -2 2197 -4 2196 2197 2179 2181 2195 2181)
    )
    (yeti
      (z-pos 50)
      (dead-script "Tux.trigger_sequence(\"fireworks\");")
      (x 96)
      (y 448)
    )
    (yeti_stalactite
      (z-pos -1)
      (x 0)
      (y 352)
    )
    (yeti_stalactite
      (z-pos -1)
      (x 32)
      (y 352)
    )
    (yeti_stalactite
      (z-pos -1)
      (x 64)
      (y 352)
    )
    (yeti_stalactite
      (z-pos -1)
      (x 96)
      (y 352)
    )
    (yeti_stalactite
      (z-pos -1)
      (x 128)
      (y 352)
    )
    (yeti_stalactite
      (z-pos -1)
      (x 160)
      (y 352)
    )
    (yeti_stalactite
      (z-pos -1)
      (x 192)
      (y 352)
    )
    (yeti_stalactite
      (z-pos -1)
      (x 224)
      (y 352)
    )
    (yeti_stalactite
      (z-pos -1)
      (x 256)
      (y 352)
    )
    (yeti_stalactite
      (z-pos -1)
      (x 288)
      (y 352)
    )
    (yeti_stalactite
      (z-pos -1)
      (x 320)
      (y 352)
    )
    (yeti_stalactite
      (z-pos -1)
      (x 352)
      (y 352)
    )
    (yeti_stalactite
      (z-pos -1)
      (x 384)
      (y 352)
    )
    (yeti_stalactite
      (z-pos -1)
      (x 416)
      (y 352)
    )
    (yeti_stalactite
      (z-pos -1)
      (x 448)
      (y 352)
    )
    (yeti_stalactite
      (z-pos -1)
      (x 480)
      (y 352)
    )
    (yeti_stalactite
      (z-pos -1)
      (x 512)
      (y 352)
    )
    (yeti_stalactite
      (z-pos -1)
      (x 544)
      (y 352)
    )
    (yeti_stalactite
      (z-pos -1)
      (x 576)
      (y 352)
    )
    (yeti_stalactite
      (z-pos -1)
      (x 608)
      (y 352)
    )
    (yeti_stalactite
      (z-pos -1)
      (x 640)
      (y 352)
    )
    (yeti_stalactite
      (z-pos -1)
      (x 672)
      (y 352)
    )
    (yeti_stalactite
      (z-pos -1)
      (x 704)
      (y 352)
    )
    (yeti_stalactite
      (z-pos -1)
      (x 736)
      (y 352)
    )
    (yeti_stalactite
      (z-pos -1)
      (x 768)
      (y 352)
    )
    (yeti_stalactite
      (z-pos -1)
      (x 800)
      (y 352)
    )
    (yeti_stalactite
      (z-pos -1)
      (x 832)
      (y 352)
    )
    (yeti_stalactite
      (z-pos -1)
      (x 864)
      (y 352)
    )
    (yeti_stalactite
      (z-pos -1)
      (x 896)
      (y 352)
    )
    (yeti_stalactite
      (z-pos -1)
      (x 928)
      (y 352)
    )
    (yeti_stalactite
      (z-pos -1)
      (x 960)
      (y 352)
    )
    (yeti_stalactite
      (z-pos -1)
      (x 992)
      (y 352)
    )
    (yeti_stalactite
      (z-pos -1)
      (x 1024)
      (y 352)
    )
    (yeti_stalactite
      (z-pos -1)
      (x 1056)
      (y 352)
    )
    (yeti_stalactite
      (z-pos -1)
      (x 1088)
      (y 352)
    )
    (yeti_stalactite
      (z-pos -1)
      (x 1120)
      (y 352)
    )
    (yeti_stalactite
      (z-pos -1)
      (x 1152)
      (y 352)
    )
    (yeti_stalactite
      (z-pos -1)
      (x 1184)
      (y 352)
    )
    (yeti_stalactite
      (z-pos -1)
      (x 1216)
      (y 352)
    )
    (yeti_stalactite
      (z-pos -1)
      (x 1248)
      (y 352)
    )
  )
)
