(supertux-level
  (version 3)
  (name (_ "A Nice Walk...?"))
  (author "Sophie Ball")
  (license "CC-BY-SA 4.0 International")
  (allow-item-pocket "inherit")
  (icon "")
  (icon-locked "")
  (statistics
    (enable-coins #f)
    (enable-badguys #f)
    (enable-secrets #f)
  )
  (sector
    (name "main")
    (ambient-light
      (color 1 1 1)
    )
    (background
      (color 1 1 1)
      (alignment "bottom")
      (speed 0.2)
      (image "images/background/antarctic/arctis2.png")
    )
    (background
      (color 1 1 1)
      (alignment "top")
      (scroll-speed-x -5)
      (speed 0)
      (image "/images/background/misc/clouds.png")
      (z-pos -301)
    )
    (camera
      (name "Camera")
      (mode "normal")
    )
    (decal
      (z-pos 50)
      (sprite "/images/creatures/adel/adel-left.png")
      (x 864)
      (y 788)
    )
    (gradient
      (top_color 0.3 0.4 0.75)
      (bottom_color 1 1 1)
      (z-pos -302)
    )
    (music
      (file "/music/misc/theme.music")
    )
    (scripttrigger
      (script "Tux.deactivate();")
      (button #f)
      (width 32)
      (height 32)
      (x 576)
      (y 832)
    )
    (spawnpoint
      (name "main")
      (x 576)
      (y 820)
    )
    (textscroller
      (file "/levels/world1/intro.txt")
      (x-offset 0)
    )
    (tilemap
      (solid #f)
      (z-pos -100)
      (width 39)
      (height 35)
      (tiles -898 0 1321 1322 1323 1324 -26 0 1321 1322 1323 1324 -5 0 1325 1326 1327 1328 -26 0 1325 1326 1327 1328 -5 0 1329 1330 1331 1332 -3 0 106 107 108 -8 0 4145 4146 4147 4148 0 106 107 108 -4 0 1329 1330 1331 1332 4137 4138 4139 4140 24 1333 1334 1335 1336 24 25 0 109 110 111 0 24 25 2625 2626 24 25 0 4149 4150 4151 4152 24 109 110 111 2623 2624 25 0 1333 1334 1335 1336 4141 4142 4143 4144 -312 0)
    )
    (tilemap
      (solid #f)
      (z-pos 100)
      (width 39)
      (height 35)
      (tiles -1365 0)
    )
    (tilemap
      (solid #t)
      (z-pos 0)
      (width 39)
      (height 35)
      (tiles -1014 0 -39 8 -3 14 3990 -17 14 3990 -2 14 3990 -2 14 3988 -3 14 3990 -6 14 3990 -13 11 19 -24 11 19 -9 11 19 -9 11 19 -41 11 19 -31 11 19 -48 11 19 -6 11 19 -53 11 19 -30 11)
    )
  )
)
