(supertux-level
  (version 3)
  (name (_ "Icy Island"))
  (author "SuperTux Player")
  (license "CC-BY-SA 4.0 International")
  (allow-item-pocket "on")
  (icon "")
  (icon-locked "")
  (sector
    (name "main")
    (ambient-light
      (color 1 1 1)
    )
    (level
      (z-pos 50)
      (level "act1.stl")
      (x 11)
      (y 15)
    )
    (level
      (z-pos 50)
      (level "act2.stl")
      (x 20)
      (y 14)
    )
    (level
      (z-pos 50)
      (level "boss.stl")
      (sprite "/images/worldmap/common/yeti.sprite")
      (x 29)
      (y 12)
    )
    (level
      (z-pos 50)
      (level "bosscutscene.stl")
      (auto-play #t)
      (sprite "/images/worldmap/common/invisible.png")
      (x 26)
      (y 13)
    )
    (level
      (z-pos 50)
      (level "intro.stl")
      (auto-play #t)
      (sprite "/images/worldmap/common/invisible.png")
      (x 4)
      (y 14)
    )
    (music
      (file "/music/worldmap/worldmap_ice.music")
    )
    (teleporter
      (z-pos 50)
      (worldmap "/levels/sickly_sewers/worldmap.stwm")
      (sector "main")
      (spawnpoint "main")
      (message (_ "Go to Sickly Sewers Zone?"))
      (x 32)
      (y 12)
    )
    (tilemap
      (solid #f)
      (z-pos -100)
      (width 100)
      (height 35)
      (tiles -3500 1)
    )
    (tilemap
      (solid #t)
      (z-pos 0)
      (width 100)
      (height 100)
      (tiles -412 0 101 -8 102 103 -85 0 101 -4 102 113 -8 105 112 -5 102 103 -77 0 101 102 113 -19 105 112 -2 102 103 -73 0 101 113 -24 105 112 103 -71 0 101 113 -26 105 112 103 -69 0 101 113 -28 105 106 -69 0 104 -29 105 112 103 -68 0 104 -30 105 106 -68 0 104 -30 105 106 648 -67 0 104 -30 105 106 -68 0 104 -29 105 110 109 -68 0 104 -29 105 106 -69 0 107 111 -28 105 106 -70 0 104 -27 105 110 109 -70 0 107 111 -25 105 110 109 -72 0 107 -9 108 111 -14 105 110 109 -83 0 107 111 -12 105 110 109 -85 0 107 -12 108 109 -7871 0)
    )
    (tilemap
      (solid #t)
      (z-pos 1)
      (width 100)
      (height 100)
      (tiles -112 0 101 -8 102 103 -90 0 104 -8 105 106 -90 0 447 -8 448 449 -90 0 450 -8 451 452 -90 0 453 -8 454 455 -4 0 181 184 187 -79 0 170 0 230 0 136 -8 137 138 0 233 0 171 182 185 188 179 -75 0 136 -4 137 138 544 139 -8 140 147 137 138 0 172 183 186 189 180 -74 0 136 148 -4 140 141 0 139 -10 140 147 138 0 192 -2 0 233 -74 0 139 -5 140 141 0 139 -11 140 141 190 193 196 -75 0 544 139 -3 140 145 143 144 0 142 143 146 -9 140 141 191 194 197 -2 0 230 -73 0 139 -2 140 145 144 0 181 184 187 0 142 -2 143 146 -6 140 141 -3 0 544 -75 0 142 -2 143 144 230 171 182 185 188 179 -3 0 142 -6 143 144 -84 0 172 183 186 189 180 0 544 -11 0 101 -2 102 103 -96 0 107 -2 108 109 -73 0 219 -2 220 221 -13 0 136 -4 137 138 0 219 220 221 -73 0 222 228 229 224 101 -2 102 103 -4 0 233 0 136 -2 137 148 -4 140 147 138 222 223 224 -73 0 222 231 232 224 104 -2 105 106 544 -3 0 136 137 148 -8 140 141 225 226 227 -73 0 225 -2 226 227 107 132 130 109 0 230 -2 0 139 -10 140 141 233 -87 0 139 -9 140 145 144 -88 0 142 -9 143 144 -7973 0)
    )
    (tilemap
      (solid #t)
      (z-pos 2)
      (width 100)
      (height 100)
      (tiles -12 0 447 -8 448 449 -90 0 450 -8 451 452 -90 0 453 -8 454 455 -981 0 115 -22 0 10 -5 20 23 -70 0 116 -22 0 21 -76 0 14 -4 20 11 -5 0 10 -11 20 15 -81 0 14 -5 20 15 -93 0 101 -2 102 103 -96 0 107 132 130 109 -8288 0)
    )
    (worldmap-spawnpoint
      (z-pos 50)
      (name "main")
      (x 3)
      (y 13)
    )
  )
  (tileset "images/ice_world.strf")
)
