(supertux-level
  (version 3)
  (name (_ "Pyramid Panic Zone"))
  (author "SuperTux Player")
  (license "CC-BY-SA 4.0 International")
  (allow-item-pocket "on")
  (icon "")
  (icon-locked "")
  (sector
    (name "main")
    (ambient-light
      (color 0.6 0.6 0.5)
    )
    (background
      (color 1 1 1)
      (speed 0)
      (fill #t)
      (image "/images/background/misc/vignette.png")
      (z-pos 300)
    )
    (level
      (z-pos 50)
      (level "act1.stl")
      (x 32)
      (y 65)
    )
    (music
      (file "/music/worldmap/arabian_princess.music")
    )
    (teleporter
      (z-pos 50)
      (worldmap "/levels/Crystalline_Cavern_Act/worldmap.stwm")
      (sector "main")
      (spawnpoint "main")
      (message (_ "Go to Crystalline Cavern Zone?"))
      (x 32)
      (y 50)
    )
    (teleporter
      (z-pos 50)
      (worldmap "/levels/Desolate_Desert/worldmap.stwm")
      (sector "main")
      (spawnpoint "back")
      (message (_ "Go back to Desolate Desert Zone?"))
      (x 32)
      (y 82)
    )
    (tilemap
      (solid #f)
      (z-pos -100)
      (width 100)
      (height 100)
      (tiles -7523 0 688 689 690 -10 0 688 -2 689 690 -83 0 692 693 694 -10 0 692 -2 693 694 -83 0 696 697 698 -10 0 692 -2 693 694 -83 0 688 -2 689 690 -9 0 696 -2 697 698 -83 0 692 -2 693 694 -2 0 688 689 690 -91 0 692 -2 693 694 -2 0 692 693 694 -3 0 688 690 -86 0 696 -2 697 698 -2 0 696 697 698 -3 0 692 694 -1863 0)
    )
    (tilemap
      (solid #t)
      (z-pos 0)
      (width 100)
      (height 100)
      (tiles -5022 0 730 -19 731 732 -79 0 734 -19 735 736 -79 0 734 -19 735 736 -79 0 734 -19 735 736 -79 0 734 -19 735 736 -79 0 734 -19 735 736 -79 0 734 -19 735 736 -79 0 734 -19 735 736 -79 0 738 -19 739 740 -379 0 730 -19 731 732 -79 0 734 -19 735 736 -79 0 734 -19 735 736 -79 0 734 -19 735 736 -79 0 734 -19 735 736 -79 0 734 -19 735 736 -79 0 734 -19 735 736 -79 0 734 -19 735 736 -79 0 738 -19 739 740 -379 0 730 -19 731 732 -79 0 734 742 739 743 -10 735 742 -2 739 743 -2 735 736 -79 0 734 736 0 734 -10 735 736 -2 0 734 -2 735 736 -79 0 734 -13 735 736 -2 0 734 -2 735 736 -79 0 734 742 739 743 -16 735 736 -79 0 734 736 0 738 743 -2 735 742 739 743 -10 735 736 -79 0 734 735 732 0 734 -2 735 736 0 734 -3 735 742 743 -5 735 736 -79 0 734 -2 735 731 -4 735 731 -4 735 736 734 -5 735 736 -79 0 738 -19 739 740 -1757 0)
    )
    (tilemap
      (solid #f)
      (tint 0.4 0.4 0.4)
      (z-pos -99)
      (width 100)
      (height 100)
      (tiles -5822 0 734 -19 735 736 -79 0 734 -19 735 736 -79 0 734 -19 735 736 -79 0 734 -19 735 736 -79 0 734 -19 735 736 -779 0 734 -19 735 736 -79 0 734 -19 735 736 -79 0 734 -19 735 736 -79 0 734 -19 735 736 -79 0 734 -19 735 736 -2557 0)
    )
    (tilemap
      (solid #t)
      (z-pos 1)
      (width 100)
      (height 100)
      (tiles -4723 0 737 0 737 0 737 0 737 0 737 0 737 0 737 0 737 0 737 0 737 -81 0 741 737 741 737 741 737 741 737 741 0 741 737 741 737 741 737 741 737 741 -81 0 -9 741 0 -9 741 -81 0 745 741 745 741 745 741 745 741 745 19 745 741 745 741 745 741 745 741 745 -82 0 745 0 745 0 745 0 745 0 21 0 745 0 745 0 745 0 745 -91 0 21 -99 0 21 -99 0 21 -99 0 21 -99 0 21 -99 0 21 -99 0 403 -90 0 737 -2 0 737 -2 0 737 -2 0 404 -2 0 737 -2 0 737 -2 0 737 -81 0 741 -2 0 741 -2 0 741 -2 0 404 -2 0 741 -2 0 741 -2 0 741 -81 0 741 -2 0 741 -2 0 741 -2 0 404 -2 0 741 -2 0 741 -2 0 741 -81 0 745 -2 0 745 -2 0 745 -2 0 405 -2 0 745 -2 0 745 -2 0 745 -90 0 21 -5 0 749 -90 0 737 -2 0 21 -2 0 744 733 -3 0 746 -83 0 733 -4 0 745 -2 0 21 -92 0 737 0 744 -4 0 21 -7 0 733 -82 0 744 0 745 -6 0 21 -5 0 737 -93 0 21 -3 0 733 0 745 -87 0 746 -2 0 733 -2 0 21 -99 0 403 -99 0 404 -99 0 404 -99 0 404 -99 0 405 -99 0 21 -90 0 733 -2 0 747 737 -2 747 -2 0 21 -7 0 733 -85 0 747 745 747 0 744 0 21 -3 0 746 -2 0 733 -85 0 747 -6 0 21 0 737 -97 0 21 0 745 747 -2 0 737 0 -2 747 -86 0 746 -3 0 21 -3 0 -2 747 745 0 -2 747 -82 0 747 744 -6 0 21 -5 0 747 -93 0 22 -1767 0)
    )
    (tilemap
      (solid #f)
      (z-pos 2)
      (width 100)
      (height 100)
      (tiles -4923 0 737 0 737 0 737 0 737 0 737 0 737 0 737 0 737 0 737 0 737 -81 0 741 0 741 0 741 0 741 0 741 0 741 0 741 0 741 0 741 0 741 -81 0 741 0 741 0 741 0 741 0 741 0 741 0 741 0 741 0 741 0 741 -81 0 745 0 745 0 745 0 745 0 745 0 745 0 745 0 745 0 745 0 745 -4758 0)
    )
    (tilemap
      (solid #f)
      (z-pos 3)
      (width 100)
      (height 100)
      (tiles -5024 0 737 0 737 0 737 0 737 -3 0 737 0 737 0 737 0 737 -83 0 741 0 741 0 741 0 741 -3 0 741 0 741 0 741 0 741 -83 0 741 0 741 0 741 0 741 -3 0 741 0 741 0 741 0 741 -83 0 745 0 745 0 745 0 745 -3 0 745 0 745 0 745 0 745 -4659 0)
    )
    (tilemap
      (solid #f)
      (z-pos 4)
      (width 100)
      (height 100)
      (tiles -5123 0 737 0 737 0 737 0 737 0 737 0 737 0 737 0 737 0 737 0 737 -81 0 741 0 741 0 741 0 741 0 741 0 741 0 741 0 741 0 741 0 741 -81 0 741 0 741 0 741 0 741 0 741 0 741 0 741 0 741 0 741 0 741 -81 0 745 0 745 0 745 0 745 0 745 0 745 0 745 0 745 0 745 0 745 -4558 0)
    )
    (tilemap
      (solid #f)
      (z-pos 5)
      (width 100)
      (height 100)
      (tiles -5224 0 737 0 737 0 737 0 737 -3 0 737 0 737 0 737 0 737 -83 0 741 0 741 0 741 0 741 -3 0 741 0 741 0 741 0 741 -83 0 741 0 741 0 741 0 741 -3 0 741 0 741 0 741 0 741 -83 0 745 0 745 0 745 0 745 -3 0 745 0 745 0 745 0 745 -4459 0)
    )
    (tilemap
      (solid #f)
      (z-pos 6)
      (width 100)
      (height 100)
      (tiles -5323 0 737 0 737 0 737 0 737 0 737 0 737 0 737 0 737 0 737 0 737 -81 0 741 0 741 0 741 0 741 0 741 0 741 0 741 0 741 0 741 0 741 -81 0 741 0 741 0 741 0 741 0 741 0 741 0 741 0 741 0 741 0 741 -81 0 745 0 745 0 745 0 745 0 745 0 745 0 745 0 745 0 745 0 745 -4358 0)
    )
    (tilemap
      (solid #f)
      (z-pos 7)
      (width 100)
      (height 100)
      (tiles -5424 0 737 0 737 0 737 0 737 -3 0 737 0 737 0 737 0 737 -83 0 741 0 741 0 741 0 741 -3 0 741 0 741 0 741 0 741 -83 0 741 0 741 0 741 0 741 -3 0 741 0 741 0 741 0 741 -83 0 745 0 745 0 745 0 745 -3 0 745 0 745 0 745 0 745 -4259 0)
    )
    (worldmap-spawnpoint
      (z-pos 50)
      (name "main")
      (x 32)
      (y 80)
    )
  )
  (tileset "images/ice_world.strf")
)
