(supertux-level
  (version 3)
  (name (_ "A Horrible Monster"))
  (author "Sophie Ball")
  (license "CC-BY-SA 4.0 International")
  (allow-item-pocket "inherit")
  (icon "")
  (icon-locked "")
  (statistics
    (enable-coins #t)
    (enable-badguys #f)
    (enable-secrets #t)
  )
  (sector
    (name "main")
    (init-script "Tux.deactivate();")
    (ambient-light
      (color 0.5 0.5 0.5)
    )
    (background
      (color 0.3 0.3 0.3)
      (speed 0.2)
      (image "/images/background/sewers/browncave2.png")
    )
    (background
      (color 0.3764706 0.254902 0)
      (scroll-speed-x -50)
      (speed 0.5)
      (image "/images/background/misc/fog.png")
      (z-pos 300)
    )
    (background
      (color 1 1 1)
      (speed 0)
      (fill #t)
      (image "/images/background/misc/vignette.png")
      (z-pos 301)
    )
    (camera
      (name "Camera")
      (mode "normal")
    )
    (gradient
      (top_color 0.3 0.4 0.75)
      (bottom_color 1 1 1)
      (z-pos -301)
    )
    (music
      (file "/music/misc/battle_theme.music")
    )
    (particles-ghosts
    )
    (scripttrigger
      (oneshot #t)
      (script "Tux.walk(200);

Text.set_font(\"normal\");

Text.set_text(\"Tux had heard of a horrible monster that lives somewhere in these sewers...\");
Text.fade_in(1);
wait(4);
Text.fade_out(1);
wait(1);

Text.set_text(\"He knew he'd have to fight it to get out of here.\");
Text.fade_in(1);
wait(4);
Text.fade_out(1);
wait(1);
Effect.fade_out(2);
wait(2);
Level.finish(true);")
      (button #f)
      (width 32)
      (height 32)
      (x 96)
      (y 928)
    )
    (spawnpoint
      (name "main")
      (x 96)
      (y 896)
    )
    (tilemap
      (solid #f)
      (z-pos -100)
      (width 100)
      (height 35)
      (tiles -3500 0)
    )
    (tilemap
      (solid #f)
      (z-pos 100)
      (width 100)
      (height 35)
      (tiles -3100 0 4553 4554 4555 4556 4553 4554 4555 4556 4553 4554 4555 4556 4553 4554 4555 4556 4553 4554 4555 4556 4553 4554 4555 4556 4553 4554 4555 4556 4553 4554 4555 4556 4553 4554 4555 4556 4553 4554 4555 4556 4553 4554 4555 4556 4553 4554 4555 4556 4553 4554 4555 4556 4553 4554 4555 4556 4553 4554 4555 4556 4553 4554 4555 4556 4553 4554 4555 4556 4553 4554 4555 4556 4553 4554 4555 4556 4553 4554 4555 4556 4553 4554 4555 4556 4553 4554 4555 4556 4553 4554 4555 4556 4553 4554 4555 4556 4553 4554 4555 4556 -300 4557)
    )
    (tilemap
      (solid #t)
      (z-pos 0)
      (width 100)
      (height 35)
      (tiles -2 4633 -2998 0 4629 4630 101 300 359 4332 4628 -93 4629 4633 4634 4333 4334 4335 4336 4632 -5 4645 4646 4648 -10 4645 -4 4633 4648 -10 4633 -3 4647 -14 4633 4648 -9 4633 4648 -5 4633 -6 4647 -23 4633 4634 4337 4338 4339 4340 4632 -7 4633 -11 4647 4646 -8 4633 4646 -2 4647 4646 -3 4647 4633 4645 4648 -4 4645 -2 4633 -5 4647 -12 4645 4646 -2 4633 -3 4647 -2 4633 -7 4647 -7 4633 -2 4647 4648 4646 -3 4647 4648 4647 -3 4633 4634 4341 4342 4343 4344 4632 -3 4633 -4 4645 4647 4646 -5 4645 4648 4633 4647 4645 -6 4633 -9 4647 4633 -4 4645 4646 -2 4645 -5 4633 4646 -6 4647 -4 4645 4633 4645 -3 4633 -8 4647 -4 4633 -2 4648 -6 4633 -10 4647 -2 4633 4634 4341 4342 4343 4344 4632 -6 4645 -2 4647 -6 4645 -3 4647 -9 4633 4647 4648 -3 4647 -2 4633 -2 4645 -5 4633 -6 4645 4648 -3 4645 4647 4645 -4 4647 -8 4633 4648 -3 4633 4646 -13 4633 4647 -2 4633 4648 4647 -2 4633 -3 4647 4633)
    )
    (tilemap
      (solid #f)
      (speed-x 0.5)
      (speed-y 0.5)
      (tint 0.5 0.5 0.5)
      (z-pos -299)
      (width 100)
      (height 35)
      (tiles -3 0 2087 2088 -3 0 2087 2088 -3 0 2087 2088 -3 0 2087 2088 -3 0 2087 2088 -3 0 2087 2088 -3 0 2087 2088 -3 0 2087 2088 -3 0 2087 2088 -3 0 2087 2088 -3 0 2087 2088 -3 0 2087 2088 -3 0 2087 2088 -3 0 2087 2088 -3 0 2087 2088 -3 0 2087 2088 -3 0 2087 2088 -3 0 2087 2088 -3 0 2087 2088 -3 0 2087 2088 -3 0 2087 2088 -3 0 2087 2088 -3 0 2087 2088 -3 0 2087 2088 -3 0 2087 2088 -3 0 2087 2088 -3 0 2087 2088 -3 0 2087 2088 -3 0 2087 2088 -3 0 2087 2088 -3 0 2087 2088 -3 0 2087 2088 -3 0 2087 2088 -3 0 2087 2088 -3 0 2087 2088 -3 0 2087 2088 -3 0 2087 2088 -3 0 2087 2088 -3 0 2087 2088 -3 0 2087 2088 -3 0 2087 2088 -3 0 2087 2088 -3 0 2087 2088 -3 0 2087 2088 -3 0 2087 2088 -3 0 2087 2088 -3 0 2087 2088 -3 0 2087 2088 -3 0 2087 2088 -3 0 2087 2088 -3 0 2087 2088 -3 0 2087 2088 -3 0 2087 2088 -3 0 2087 2088 -3 0 2087 2088 -3 0 2087 2088 -3 0 2087 2088 -3 0 2087 2088 -3 0 2087 2088 -3 0 2087 2088 -3 0 2087 2088 -3 0 2087 2088 -3 0 2087 2088 -3 0 2087 2088 -3 0 2087 2088 -3 0 2087 2088 -3 0 2087 2088 -3 0 2087 2088 -3 0 2087 2088 -3 0 2087 2088 -3 0 2087 2088 -3 0 2087 2088 -3 0 2087 2088 -3 0 2087 2088 -3 0 2087 2088 -3 0 2087 2088 -3 0 2087 2088 -3 0 2087 2088 -3 0 2087 2088 -3 0 2087 2088 -3 0 2087 2088 -3 0 2087 2088 -3 0 2087 2088 -3 0 2087 2088 -3 0 2087 2088 -3 0 2087 2088 -3 0 2087 2088 -3 0 2087 2088 -3 0 2087 2088 -3 0 2087 2088 -3 0 2087 2088 -3 0 2087 2088 -3 0 2087 2088 -3 0 2087 2088 -3 0 2087 2088 -3 0 2087 2088 -3 0 2087 2088 -3 0 2087 2088 -3 0 2087 2088 -3 0 2087 2088 -3 0 2087 2088 -3 0 2087 2088 -3 0 2087 2088 -3 0 2087 2088 -3 0 2087 2088 -3 0 2087 2088 -3 0 2087 2088 -3 0 2087 2088 -3 0 2087 2088 -3 0 2087 2088 -3 0 2087 2088 -3 0 2087 2088 -3 0 2087 2088 -3 0 2087 2088 -3 0 2087 2088 -3 0 2087 2088 -3 0 2087 2088 -3 0 2087 2088 -3 0 2087 2088 -3 0 2087 2088 -3 0 2087 2088 -3 0 2087 2088 -3 0 2087 2088 -3 0 2087 2088 -3 0 2087 2088 -3 0 2087 2088 -3 0 2087 2088 -3 0 2087 2088 -3 0 2087 2088 -3 0 2087 2088 -3 0 2087 2088 -3 0 2087 2088 -3 0 2087 2088 -3 0 2087 2088 -3 0 2087 2088 -3 0 2087 2088 -3 0 2087 2088 -3 0 2087 2088 -3 0 2087 2088 -3 0 2087 2088 -3 0 2087 2088 -3 0 2087 2088 -3 0 2087 2088 -3 0 2087 2088 -3 0 2087 2088 -3 0 2087 2088 -3 0 2087 2088 -3 0 2087 2088 -3 0 2087 2088 -3 0 2087 2088 -3 0 2087 2088 -3 0 2087 2088 -3 0 2087 2088 -3 0 2087 2088 -3 0 2087 2088 -3 0 2087 2088 -3 0 2087 2088 -3 0 2087 2088 -3 0 2087 2088 -3 0 2087 2088 -3 0 2087 2088 -3 0 2087 2088 -3 0 2087 2088 -3 0 2087 2088 -3 0 2087 2088 -3 0 2087 2088 -3 0 2087 2088 -3 0 2087 2088 -3 0 2087 2088 -3 0 2087 2088 -3 0 2087 2088 -3 0 2087 2088 -3 0 2087 2088 -3 0 2087 2088 -3 0 2087 2088 -3 0 2087 2088 -3 0 2087 2088 -3 0 2087 2088 -3 0 2087 2088 -3 0 2087 2088 -3 0 2087 2088 -3 0 2087 2088 -3 0 2087 2088 -3 0 2087 2088 -3 0 2087 2088 -3 0 2087 2088 -3 0 2087 2088 -3 0 2087 2088 -3 0 2087 2088 -3 0 2087 2088 -3 0 2087 2088 -3 0 2087 2088 -3 0 2087 2088 -3 0 2087 2088 -3 0 2087 2088 -3 0 2087 2088 -3 0 2087 2088 -3 0 2087 2088 -3 0 2087 2088 -3 0 2087 2088 -3 0 2087 2088 -3 0 2087 2088 -3 0 2087 2088 -3 0 2087 2088 -3 0 2087 2088 -3 0 2087 2088 -3 0 2087 2088 -3 0 2087 2088 -3 0 2087 2088 -3 0 2087 2088 -3 0 2087 2088 -3 0 2087 2088 -3 0 2087 2088 -3 0 2087 2088 -3 0 2087 2088 -3 0 2087 2088 -3 0 2087 2088 -3 0 2087 2088 -3 0 2087 2088 -3 0 2087 2088 -3 0 2087 2088 -3 0 2087 2088 -3 0 2087 2088 -3 0 2087 2088 -3 0 2087 2088 -3 0 2087 2088 -3 0 2087 2088 -3 0 2087 2088 -3 0 2087 2088 -3 0 2087 2088 -3 0 2087 2088 -3 0 2087 2088 -3 0 2087 2088 -3 0 2087 2088 -3 0 2087 2088 -3 0 2087 2088 -3 0 2087 2088 -3 0 2087 2088 -3 0 2087 2088 -3 0 2087 2088 -3 0 2087 2088 -3 0 2087 2088 -3 0 2087 2088 -3 0 2087 2088 -3 0 2087 2088 -3 0 2087 2088 -3 0 2087 2088 -3 0 2087 2088 -3 0 2087 2088 -3 0 2087 2088 -3 0 2087 2088 -3 0 2087 2088 -3 0 2087 2088 -3 0 2087 2088 -3 0 2087 2088 -3 0 2087 2088 -3 0 2087 2088 -3 0 2087 2088 -3 0 2087 2088 -3 0 2087 2088 -3 0 2087 2088 -3 0 2087 2088 -3 0 2087 2088 -3 0 2087 2088 -3 0 2087 2088 -3 0 2087 2088 -3 0 2087 2088 -3 0 2087 2088 -3 0 2087 2088 -3 0 2087 2088 -3 0 2087 2088 -3 0 2087 2088 -3 0 2087 2088 -3 0 2087 2088 -3 0 2087 2088 -3 0 2087 2088 -3 0 2087 2088 -3 0 2087 2088 -3 0 2087 2088 -3 0 2087 2088 -3 0 2087 2088 -3 0 2087 2088 -3 0 2087 2088 -3 0 2087 2088 -3 0 2087 2088 -3 0 2087 2088 -3 0 2087 2088 -3 0 2087 2088 -3 0 2087 2088 -3 0 2087 2088 -3 0 2087 2088 -3 0 2087 2088 -3 0 2087 2088 -3 0 2087 2088 -3 0 2087 2088 -3 0 2087 2088 -3 0 2087 2088 -3 0 2087 2088 -3 0 2087 2088 -3 0 2087 2088 -3 0 2087 2088 -3 0 2087 2088 -3 0 2087 2088 -3 0 2087 2088 -3 0 2087 2088 -3 0 2087 2088 -3 0 2087 2088 -3 0 2087 2088 -3 0 2087 2088 -3 0 2087 2088 -3 0 2087 2088 -3 0 2087 2088 -3 0 2087 2088 -3 0 2087 2088 -3 0 2087 2088 -3 0 2087 2088 -3 0 2087 2088 -3 0 2087 2088 -3 0 2087 2088 -3 0 2087 2088 -3 0 2087 2088 -3 0 2087 2088 -3 0 2087 2088 -3 0 2087 2088 -3 0 2087 2088 -3 0 2087 2088 -3 0 2087 2088 -3 0 2087 2088 -3 0 2087 2088 -3 0 2087 2088 -3 0 2087 2088 -3 0 2087 2088 -3 0 2087 2088 -3 0 2087 2088 -3 0 2087 2088 -3 0 2087 2088 -3 0 2087 2088 -3 0 2087 2088 -3 0 2087 2088 -3 0 2087 2088 -3 0 2087 2088 -3 0 2087 2088 -3 0 2087 2088 -3 0 2087 2088 -3 0 2087 2088 -3 0 2087 2088 -3 0 2087 2088 -3 0 2087 2088 -3 0 2087 2088 -3 0 2087 2088 -3 0 2087 2088 -3 0 2087 2088 -3 0 2087 2088 -3 0 2087 2088 -3 0 2087 2088 -3 0 2087 2088 -3 0 2087 2088 -3 0 2087 2088 -3 0 2087 2088 -3 0 2087 2088 -3 0 2087 2088 -3 0 2087 2088 -3 0 2087 2088 -3 0 2087 2088 -3 0 2087 2088 -3 0 2087 2088 -3 0 2087 2088 -3 0 2087 2088 -3 0 2087 2088 -3 0 2087 2088 -3 0 2087 2088 -3 0 2087 2088 -3 0 2087 2088 -3 0 2087 2088 -3 0 2087 2088 -3 0 2087 2088 -3 0 2087 2088 -3 0 2087 2088 -3 0 2087 2088 -3 0 2087 2088 -3 0 2087 2088 -3 0 2087 2088 -3 0 2087 2088 -3 0 2087 2088 -3 0 2087 2088 -3 0 2087 2088 -3 0 2087 2088 -3 0 2087 2088 -3 0 2087 2088 -3 0 2087 2088 -3 0 2087 2088 -3 0 2087 2088 -3 0 2087 2088 -3 0 2087 2088 -3 0 2087 2088 -3 0 2087 2088 -3 0 2087 2088 -3 0 2087 2088 -3 0 2087 2088 -3 0 2087 2088 -3 0 2087 2088 -3 0 2087 2088 -3 0 2087 2088 -3 0 2087 2088 -3 0 2087 2088 -3 0 2087 2088 -3 0 2087 2088 -3 0 2087 2088 -3 0 2087 2088 -3 0 2087 2088 -3 0 2087 2088 -3 0 2087 2088 -3 0 2087 2088 -3 0 2087 2088 -3 0 2087 2088 -3 0 2087 2088 -3 0 2087 2088 -3 0 2087 2088 -3 0 2087 2088 -3 0 2087 2088 -3 0 2087 2088 -3 0 2087 2088 -3 0 2087 2088 -3 0 2087 2088 -3 0 2087 2088 -3 0 2087 2088 -3 0 2087 2088 -3 0 2087 2088 -3 0 2087 2088 -3 0 2087 2088 -3 0 2087 2088 -3 0 2087 2088 -3 0 2087 2088 -3 0 2087 2088 -3 0 2087 2088 -3 0 2087 2088 -3 0 2087 2088 -3 0 2087 2088 -3 0 2087 2088 -3 0 2087 2088 -3 0 2087 2088 -3 0 2087 2088 -3 0 2087 2088 -3 0 2087 2088 -3 0 2087 2088 -3 0 2087 2088 -3 0 2087 2088 -3 0 2087 2088 -3 0 2087 2088 -3 0 2087 2088 -3 0 2087 2088 -3 0 2087 2088 -3 0 2087 2088 -3 0 2087 2088 -3 0 2087 2088 -3 0 2087 2088 -3 0 2087 2088 -3 0 2087 2088 -3 0 2087 2088 -3 0 2087 2088 -3 0 2087 2088 -3 0 2087 2088 -3 0 2087 2088 -3 0 2087 2088 -3 0 2087 2088 -3 0 2087 2088 -3 0 2087 2088 -3 0 2087 2088 -3 0 2087 2088 -3 0 2087 2088 -3 0 2087 2088 -3 0 2087 2088 -3 0 2087 2088 -3 0 2087 2088 -3 0 2087 2088 -3 0 2087 2088 -3 0 2087 2088 -3 0 2087 2088 -3 0 2087 2088 -3 0 2087 2088 -3 0 2087 2088 -3 0 2087 2088 -3 0 2087 2088 -3 0 2087 2088 -3 0 2087 2088 -3 0 2087 2088 -3 0 2087 2088 -3 0 2087 2088 -3 0 2087 2088 -3 0 2087 2088 -3 0 2087 2088 -3 0 2087 2088 -3 0 2087 2088 -3 0 2087 2088 -3 0 2087 2088 -3 0 2087 2088 -3 0 2087 2088 -3 0 2087 2088 -3 0 2087 2088 -3 0 2087 2088 -3 0 2087 2088 -3 0 2087 2088 -3 0 2087 2088 -3 0 2087 2088 -3 0 2087 2088 -3 0 2087 2088 -3 0 2087 2088 -3 0 2087 2088 -3 0 2087 2088 -3 0 2087 2088 -3 0 2087 2088 -3 0 2087 2088 -3 0 2087 2088 -3 0 2087 2088 -3 0 2087 2088 -3 0 2087 2088 -3 0 2087 2088 -3 0 2087 2088 -3 0 2087 2088 -3 0 2087 2088 -3 0 2087 2088 -3 0 2087 2088 -3 0 2087 2088 -3 0 2087 2088 -3 0 2087 2088 -3 0 2087 2088 -3 0 2087 2088 -3 0 2087 2088 -3 0 2087 2088 -3 0 2087 2088 -3 0 2087 2088 -3 0 2087 2088 -3 0 2087 2088 -3 0 2087 2088 -3 0 2087 2088 -3 0 2087 2088 -3 0 2087 2088 -3 0 2087 2088 -3 0 2087 2088 -3 0 2087 2088 -3 0 2087 2088 -3 0 2087 2088 -3 0 2087 2088 -3 0 2087 2088 -3 0 2087 2088 -3 0 2087 2088 -3 0 2087 2088 -3 0 2087 2088 -3 0 2087 2088 -3 0 2087 2088 -3 0 2087 2088 -3 0 2087 2088 -3 0 2087 2088 -3 0 2087 2088 -3 0 2087 2088 -3 0 2087 2088 -3 0 2087 2088 -3 0 2087 2088 -3 0 2087 2088 -3 0 2087 2088 -3 0 2087 2088 -3 0 2087 2088 -3 0 2087 2088 -3 0 2087 2088 -3 0 2087 2088 -3 0 2087 2088 -3 0 2087 2088 -3 0 2087 2088 -3 0 2087 2088 -3 0 2087 2088 -3 0 2087 2088 -3 0 2087 2088 -3 0 2087 2088 -3 0 2087 2088 -3 0 2087 2088 -3 0 2087 2088 -3 0 2087 2088 -3 0 2087 2088 -3 0 2087 2088 -3 0 2087 2088 -3 0 2087 2088 -3 0 2087 2088 -3 0 2087 2088 -3 0 2087 2088 -3 0 2087 2088 -3 0 2087 2088 -3 0 2087 2088 -3 0 2087 2088 -3 0 2087 2088 -3 0 2087 2088 -3 0 2087 2088 -3 0 2087 2088 -3 0 2087 2088 -3 0 2087 2088 -3 0 2087 2088 -3 0 2087 2088 -3 0 2087 2088 -3 0 2087 2088 -3 0 2087 2088 -3 0 2087 2088 -3 0 2087 2088 -3 0 2087 2088 -3 0 2087 2088 -3 0 2087 2088 -3 0 2087 2088 -3 0 2087 2088 -3 0 2087 2088 -3 0 2087 2088 -3 0 2087 2088 -3 0 2087 2088 -3 0 2087 2088 -3 0 2087 2088 -3 0 2087 2088 -3 0 2087 2088 -3 0 2087 2088 -3 0 2087 2088 -3 0 2087 2088 -3 0 2087 2088 -3 0 2087 2088 -3 0 2087 2088 -3 0 2087 2088 -3 0 2087 2088 -3 0 2087 2088 -3 0 2087 2088 -3 0 2087 2088 -3 0 2087 2088 -3 0 2087 2088 -3 0 2087 2088 -3 0 2087 2088 -3 0 2087 2088 -3 0 2087 2088 -3 0 2087 2088 -3 0 2087 2088 -3 0 2087 2088 -3 0 2087 2088 -3 0 2087 2088 -3 0 2087 2088 -3 0 2087 2088 -3 0 2087 2088 -3 0 2087 2088 -3 0 2087 2088 -3 0 2087 2088 -3 0 2087 2088 -3 0 2087 2088 -3 0 2087 2088 -3 0 2087 2088 -3 0 2087 2088 -3 0 2087 2088 -3 0 2087 2088 -3 0 2087 2088 -3 0 2087 2088 -3 0 2087 2088 -3 0 2087 2088 -3 0 2087 2088 -3 0 2087 2088 -3 0 2087 2088 -3 0 2087 2088 -3 0 2087 2088 -3 0 2087 2088 -3 0 2087 2088 -3 0 2087 2088 -3 0 2087 2088 -3 0 2087 2088 -3 0 2087 2088 -3 0 2087 2088 -3 0 2087 2088 -3 0 2087 2088 -3 0 2087 2088 -3 0 2087 2088 -3 0 2087 2088 -3 0 2087 2088 -3 0 2087 2088 -3 0 2087 2088 -3 0 2087 2088 -3 0 2087 2088 -3 0 2087 2088 -3 0 2087 2088 -3 0 2087 2088 -3 0 2087 2088 -3 0 2087 2088 -3 0 2087 2088 -3 0 2087 2088 -3 0 2087 2088 -3 0 2087 2088 -3 0 2087 2088 -3 0 2087 2088 -3 0 2087 2088 -3 0 2087 2088 -3 0 2087 2088 -3 0 2087 2088 -3 0 2087 2088 -3 0 2087 2088 -3 0 2087 2088 -3 0 2087 2088 -3 0 2087 2088 -3 0 2087 2088 -3 0 2087 2088 -3 0 2087 2088 -3 0 2087 2088 -3 0 2087 2088)
    )
  )
)
