(supertux-level
  (version 3)
  (name (_ "Frankenpipe The Pipester"))
  (author "Sophie Ball")
  (note (_ "Act Boss"))
  (license "CC-BY-SA 4.0 International")
  (allow-item-pocket "inherit")
  (icon "")
  (icon-locked "")
  (statistics
    (enable-coins #t)
    (enable-badguys #f)
    (enable-secrets #t)
  )
  (sector
    (name "main")
    (ambient-light
      (color 0.5 0.5 0.5)
    )
    (background
      (color 0.4 0.4 0.4)
      (speed 0.2)
      (image "/images/background/sewers/browncave2.png")
      (z-pos -301)
    )
    (background
      (color 0.3686275 0.3254902 0)
      (scroll-speed-x -50)
      (speed 0.5)
      (image "/images/background/misc/fog.png")
      (z-pos 300)
    )
    (background
      (color 1 1 1)
      (speed 0)
      (fill #t)
      (image "/images/background/misc/vignette.png")
      (z-pos 300)
    )
    (camera
      (name "Camera")
      (mode "normal")
    )
    (ghosttree
      (z-pos -1)
      (dead-script "Tux.trigger_sequence(\"fireworks\");")
      (sprite "/images/creatures/frankenpipe/frankenpipe.sprite")
      (x 905)
      (y 838)
      (hud-icon "images/creatures/ghosttree/hudlife.png")
      (lives 3)
      (pinch-lives 0)
    )
    (gradient
      (top_color 0 0 0)
      (bottom_color 0.2666667 0.1921569 0)
      (z-pos -302)
    )
    (lantern
      (z-pos 50)
      (color 0 0 0)
      (x 640)
      (y 976)
    )
    (leveltime
      (time 60)
    )
    (music
      (file "/music/boss/treeboss.music")
    )
    (particles-ghosts
    )
    (spawnpoint
      (name "main")
      (x 64)
      (y 960)
    )
    (text-area
      (width 32)
      (height 32)
      (x 64)
      (y 992)
      (once #t)
      (delay 2)
      (fade-delay 1)
      (anchor-offset-x 0)
      (anchor-offset-y 0)
      (strings "Blue, Red, Green")
    )
    (tilemap
      (solid #f)
      (z-pos -100)
      (width 100)
      (height 35)
      (tiles -3500 0)
    )
    (tilemap
      (solid #f)
      (z-pos 100)
      (width 100)
      (height 35)
      (tiles -3500 0)
    )
    (tilemap
      (solid #t)
      (z-pos 0)
      (width 100)
      (height 35)
      (tiles -4 4633 -3 4647 -3 4645 4633 -2 4647 -6 4633 4647 -4 4633 4645 -3 4647 -4 4633 4645 -3 4647 -4 4633 -2 4646 4645 -2 4647 4645 4648 -2 4645 4646 4645 4647 4633 -2 4646 4645 -2 4647 4645 4648 -2 4645 4633 -2 4646 4645 -2 4647 4645 4648 -2 4645 4646 4645 4633 -2 4646 4645 -2 4647 4645 4648 -2 4645 4646 4645 4633 -2 4646 4633 -2 4646 4645 -2 4647 4645 4648 -2 4645 4646 -3 4633 -2 4647 4633 -2 4645 4633 4645 4646 4633 -2 4647 -5 4633 4647 -3 4633 -3 4645 -2 4647 -3 4633 -3 4645 4633 -2 4647 -3 4633 -2 4646 4645 -2 4647 4633 -2 4645 4633 4646 4645 -2 4633 -2 4646 4645 -2 4647 4633 -2 4645 -2 4633 -2 4646 4645 -2 4647 4633 -2 4645 4633 4646 4645 4633 -2 4646 4645 -2 4647 4633 -2 4645 4633 4646 4645 4633 -2 4646 4633 -2 4646 4645 -2 4647 4633 -2 4645 4633 4646 -3 4633 4647 4633 4645 -5 4647 -2 4633 4648 -5 4633 4647 -4 4633 4645 -3 4647 -4 4633 4645 4647 -2 4633 4648 -3 4633 -2 4645 -2 4647 -2 4633 -4 4645 4647 -2 4633 -2 4645 -2 4647 -2 4633 -3 4645 4633 -2 4645 -2 4647 -2 4633 -4 4645 4647 4633 -2 4645 -2 4647 -2 4633 -4 4645 4647 4633 -2 4645 4633 -2 4645 -2 4647 -2 4633 -4 4645 -3 4633 4647 4633 -2 4647 -3 4633 -2 4647 4633 4647 -5 4633 4647 -3 4633 -3 4645 -2 4647 -3 4633 -3 4645 4647 4633 4647 -3 4633 -5 4647 -2 4645 4633 4645 -2 4647 4648 4633 -5 4647 -2 4645 4633 4645 4633 -5 4647 -2 4645 4633 4645 -2 4647 4633 -5 4647 -2 4645 4633 4645 -2 4647 4633 -2 4647 4633 -5 4647 -2 4645 4633 4645 4647 -3 4633 4647 4645 4647 -4 4633 4645 -3 4647 -5 4633 4647 4645 4648 -2 4645 4646 4645 -2 4647 4645 4648 -2 4645 4646 4645 -3 4647 -3 4633 -5 4647 -4 4645 -2 4647 4645 4633 -5 4647 -4 4645 4633 -5 4647 -4 4645 -2 4647 4633 -4 4647 4633 -2 4646 4645 -2 4647 4645 4648 -2 4645 4646 4645 -4 4647 -4 4645 4647 -2 4633 -2 4647 4646 4647 -3 4633 -3 4645 -2 4647 4633 4645 -3 4633 4647 4633 -2 4645 4633 4646 4645 -2 4647 4633 -2 4645 4633 4646 4645 -3 4633 4645 4647 4633 -2 4647 4633 4645 -6 4647 4633 4645 4633 -2 4647 4633 4645 -5 4647 4633 -2 4647 4633 4645 -6 4647 -2 4633 -2 4647 4633 4645 4633 -2 4646 4645 -2 4647 4633 -2 4645 4633 4646 4645 -2 4633 4645 -6 4647 -2 4633 -2 4647 4645 4647 4645 4648 -2 4645 4646 4645 -2 4647 4633 4645 -5 4633 -4 4645 -2 4647 -2 4633 -4 4645 4647 -2 4633 -3 4645 4633 -2 4647 4633 4645 4647 -2 4648 -3 4647 4633 4645 4633 -2 4647 4633 4645 4647 -2 4648 -2 4647 4633 -2 4647 4633 4645 4647 -2 4648 -3 4647 -2 4633 -2 4647 4633 4645 4633 -2 4645 -2 4647 -2 4633 -4 4645 4647 -2 4633 4645 4647 -2 4648 -3 4647 -3 4633 -3 4647 4633 -2 4645 4633 4646 4645 -2 4647 -3 4645 -2 4633 4647 -2 4645 4633 4645 -4 4647 -2 4645 4633 4645 -2 4647 4648 -2 4645 4646 4645 4633 -5 4647 -2 4645 4633 4645 -2 4647 4648 4633 -5 4647 -2 4645 4633 4645 4633 -5 4647 -2 4645 4633 4645 -2 4647 4633 -4 4647 4633 -5 4647 -2 4645 4633 4645 -2 4647 4648 -3 4647 -2 4645 4633 4645 4647 -7 4633 4647 -4 4633 4645 -3 4647 -4 4633 4645 4647 -2 4645 -4 4647 -4 4645 -2 4647 -2 4645 4633 4646 4645 4633 -5 4647 -4 4645 -2 4647 4645 4633 -5 4647 -4 4645 4633 -5 4647 -4 4645 -2 4647 4633 -4 4647 4633 -5 4647 -4 4645 -2 4647 4645 -3 4647 -4 4645 4647 -2 4633 4645 -4 4633 4647 -3 4633 -3 4645 -2 4647 -3 4633 -3 4645 -3 4647 4633 4645 -5 4647 4644 4633 -4 4645 4647 4633 -2 4647 4633 4645 -6 4647 4633 4645 4633 -2 4647 4633 4645 -5 4647 4633 -2 4647 4633 4645 -6 4647 -2 4633 -2 4647 4633 4645 4633 -2 4647 4633 4645 -6 4647 4633 4645 4633 4645 -6 4647 -2 4633 4645 -4 4633 4647 4645 4648 -2 4645 4646 4645 -2 4647 4645 4648 -2 4645 4646 4645 -3 4647 4633 4645 4647 -2 4648 -3 4647 4633 4645 4633 4645 -2 4647 4633 4646 4647 4633 4645 4647 -2 4648 -3 4647 4633 4645 4633 4646 4647 4633 4645 4647 -2 4648 -2 4647 4633 4646 4647 4633 4645 4647 -2 4648 -3 4647 -2 4633 4646 4647 4633 4645 4633 -2 4647 4633 4645 4647 -2 4648 -3 4647 4633 4645 4633 4645 4647 -2 4648 -3 4647 -2 4633 -2 4645 4644 -2 4633 4647 4633 -2 4645 4633 4646 4645 -2 4647 4633 -2 4645 4633 4646 4645 4647 4633 4647 4645 4646 -4 4647 4633 4647 -4 4645 -2 4647 4633 4645 4646 4645 -2 4647 4633 -2 4645 4633 4646 4645 -2 4633 4645 4646 4645 -2 4647 4633 -2 4645 -2 4633 4645 4646 4645 -2 4647 4633 -2 4645 4633 4646 4645 4633 4645 4646 4645 4647 4633 -5 4647 -2 4645 4633 4645 -2 4647 4648 4645 -2 4647 4633 -2 4645 4633 4646 4633 -3 4645 -5 4633 -4 4645 -2 4647 -2 4633 -4 4645 4647 -2 4645 4647 -2 4645 -3 4647 -2 4645 4647 4645 -4 4647 -2 4633 4647 4645 -2 4647 -2 4633 -4 4645 4647 -2 4633 4647 4645 -2 4647 -2 4633 -3 4645 4633 4647 4645 -2 4647 -2 4633 -4 4645 4647 4633 4647 4645 -2 4647 4633 -5 4647 -4 4645 -2 4647 4645 -2 4647 -2 4633 -4 4645 -41 4637 4650 -3 4647 -2 4645 4633 4645 -2 4647 4648 4633 -5 4647 -2 4645 4633 4645 4633 -5 4647 -2 4645 4633 4645 -2 4647 4633 -4 4647 4633 -2 4647 4633 4645 -6 4647 4633 4645 -3 4647 -2 4645 4633 4645 4647 -39 0 2143 2144 4632 -3 4647 -4 4645 -2 4647 4645 4633 -5 4647 -4 4645 4633 -5 4647 -4 4645 -2 4647 4633 -4 4647 4633 4646 4647 4633 4645 4647 -2 4648 -3 4647 4633 4645 -3 4647 -4 4645 4647 -39 0 2146 2147 4632 4633 4645 -6 4647 4633 4645 4633 -2 4647 4633 4645 -5 4647 4633 -2 4647 4633 4645 -6 4647 -2 4633 -2 4647 4633 4645 4633 4645 4646 4645 -2 4647 4633 -2 4645 4633 4646 4645 -2 4633 4645 -6 4647 -39 0 2143 2144 4632 4633 4645 4647 -2 4648 -3 4647 4633 4645 4633 4646 4647 4633 4645 4647 -2 4648 -2 4647 4633 4646 4647 4633 4645 4647 -2 4648 -3 4647 -2 4633 4646 4647 4633 4645 4633 4647 4645 -2 4647 -2 4633 -4 4645 4647 -2 4633 4645 4647 -2 4648 -3 4647 -39 0 2146 2147 4632 -2 4647 -2 4633 -4 4645 4647 -2 4633 4646 4645 -2 4647 -2 4633 -3 4645 4633 4646 4645 -2 4647 -2 4633 -4 4645 4647 4633 4646 4645 -2 4647 4633 -5 4647 -2 4645 4633 4645 -2 4647 4648 -2 4647 -2 4633 -4 4645 -39 0 2143 2144 4632 -3 4647 -2 4645 4633 4645 -2 4647 4648 -2 4645 -4 4647 -2 4645 4633 -3 4645 -4 4647 -2 4645 4633 4645 -2 4647 -2 4645 -3 4647 4633 -5 4647 -4 4645 -2 4647 4645 -3 4647 -2 4645 4633 4645 4647 -39 0 2146 2147 4632 -3 4647 -4 4645 -2 4647 -2 4645 -5 4647 -5 4645 -5 4647 -4 4645 -2 4647 4645 -4 4647 4633 -2 4647 4633 4645 -6 4647 4633 4645 -3 4647 -4 4645 4647 -39 0 2143 2144 4632 4633 4645 -6 4647 4633 -2 4645 -2 4647 4633 4645 -5 4647 4645 -2 4647 4633 4645 -6 4647 4633 4645 -2 4647 4633 4645 4633 4646 4647 4633 4645 4647 -2 4648 -3 4647 4633 4645 4633 4645 -6 4647 -39 0 2146 2147 4632 4633 4645 4647 -2 4648 -3 4647 4633 -2 4645 -2 4647 4633 4645 4647 -2 4648 -2 4647 4645 -2 4647 4633 4645 4647 -2 4648 -3 4647 4633 4645 -2 4647 4633 4645 4633 4646 4645 -2 4647 -2 4633 -4 4645 4647 -2 4633 4645 4647 -2 4648 -3 4647 -39 0 2143 2144 4632 4645 -2 4647 4644 -2 4645 4633 4646 4645 4633 4645 4647 4646 4645 -2 4647 4633 -2 4645 4633 4645 4647 4646 4645 -2 4647 4633 -2 4645 4633 4646 -2 4645 4647 4646 4645 4647 -2 4645 -4 4647 -2 4645 4633 4645 -2 4647 4648 4645 -2 4647 4633 -2 4645 4633 4646 -39 0 2146 2147 4632 -2 4647 -2 4633 -4 4645 4647 4633 4645 4646 4645 -2 4647 -2 4633 -4 4645 4646 4645 -2 4647 -2 4633 -4 4645 4647 4645 4646 4645 -2 4647 4645 -5 4647 -4 4645 -2 4647 4645 -2 4647 -2 4633 -4 4645 -15 0 4640 4641 4642 -21 0 2143 2144 4632 -3 4647 -2 4645 4633 4645 -2 4647 4648 4645 4646 -4 4647 -2 4645 4633 -2 4645 4646 -4 4647 -2 4645 4633 4645 -2 4647 4645 4646 -3 4647 4645 -2 4647 4633 4645 -6 4647 4633 4645 -3 4647 -2 4645 4633 4645 4647 -39 0 2146 2147 4632 -3 4647 -4 4645 -2 4647 -3 4645 -4 4647 -6 4645 -4 4647 -4 4645 -2 4647 -2 4645 -3 4647 4645 -2 4647 4633 4645 4647 -2 4648 -3 4647 4633 4645 -3 4647 -4 4645 4647 -39 0 2143 2144 4632 4633 4645 -6 4647 4633 -2 4645 -2 4647 4633 4645 -5 4647 4645 -2 4647 4633 4645 -6 4647 4633 4645 -2 4647 4633 -2 4645 4647 4646 4645 -2 4647 4633 -2 4645 4633 4646 4645 -2 4633 4645 -6 4647 -39 0 2146 2147 4632 4633 4645 4647 -2 4648 -3 4647 4633 -2 4645 -2 4647 4633 4645 4647 -2 4648 -2 4647 4645 -2 4647 4633 4645 4647 -2 4648 -3 4647 4633 4645 -2 4647 4633 -2 4645 4646 4645 -2 4647 -2 4633 -4 4645 4647 -2 4633 4645 4647 -2 4648 -3 4647 -19 0 4640 4641 4642 -17 0 2143 2144 4632 4645 -2 4647 4645 4648 -2 4645 4646 4645 4647 4645 4647 4646 4645 -2 4647 4645 4648 -3 4645 4647 4646 4645 -2 4647 4645 4648 -2 4645 4646 -2 4645 4647 4646 4645 4647 4645 4646 -4 4647 -2 4645 4633 4645 -2 4647 4648 4645 -2 4647 4645 4648 -2 4645 4646 -39 0 2146 2147 4632 4645 -2 4647 4633 -2 4645 4633 4646 4645 4633 4645 4647 4646 4645 -2 4647 4633 -2 4645 4633 4645 4647 4646 4645 -2 4647 4633 -2 4645 4633 4646 -2 4645 4647 4646 4645 4647 -2 4645 -4 4647 -4 4645 -2 4647 -2 4645 -2 4647 4633 -2 4645 4633 4646 -39 0 2143 2144 4632 -2 4647 -2 4633 -4 4645 4647 4633 4645 4647 4645 -2 4647 -2 4633 -4 4645 4647 4645 -2 4647 -2 4633 -4 4645 4647 4645 4647 4645 -2 4647 4645 -2 4647 4633 4645 -6 4647 4633 4645 -2 4647 -2 4633 -4 4645 -39 0 2146 2147 4632 -3 4647 -2 4645 4633 4645 -2 4647 4648 4645 -5 4647 -2 4645 4633 -2 4645 -5 4647 -2 4645 4633 4645 -2 4647 4645 -4 4647 4645 -2 4647 4633 4645 4647 -2 4648 -3 4647 4633 4645 -3 4647 -2 4645 4633 4645 4647 -41 4629 4654 -3 4647 -4 4645 -2 4647 -2 4645 -5 4647 -5 4645 -5 4647 -4 4645 -2 4647 4645 -4 4647 4645 4647 4646 4645 -2 4647 4645 4648 -2 4645 4646 4645 -4 4647 -4 4645 4647 -4 4633 4647 -3 4633 -3 4645 -2 4647 4644 -2 4633 -2 4645 4647 -3 4633 -3 4645 4647 -3 4633 -3 4645 -2 4647 -3 4633 -3 4645 -2 4647 4633 4645 -6 4647 4633 -2 4645 -2 4647 4633 4645 -5 4647 4645 -2 4647 4633 4645 -6 4647 4633 4645 -2 4647 4633 -2 4645 4647 4646 4645 -2 4647 4633 -2 4645 4633 4646 4645 -2 4633 4645 -6 4647 -4 4633 4647 4645 4648 -2 4645 4646 4645 -2 4647 4645 4648 -2 4645 4646 4647 4645 4648 -2 4645 4646 4645 4647 4645 4648 -2 4645 4646 4645 -2 4647 4645 4648 -2 4645 4646 4645 -2 4647 4633 4645 4647 -2 4648 -3 4647 4633 -2 4645 -2 4647 4633 4645 4647 -2 4648 -2 4647 4645 -2 4647 4633 4645 4647 -2 4648 -3 4647 4633 4645 -2 4647 4633 -2 4645 4647 4645 -2 4647 -2 4633 -4 4645 4647 -2 4633 4645 4647 -2 4648 -3 4647)
    )
    (tilemap
      (solid #f)
      (tint 0.5 0.5 0.5)
      (z-pos -300)
      (width 100)
      (height 35)
      (tiles 0 2087 2088 -3 0 2087 2088 -3 0 2087 2088 -3 0 2087 2088 -3 0 2087 2088 -3 0 2087 2088 -3 0 2087 2088 -3 0 2087 2088 -3 0 2087 2088 -3 0 2087 2088 -3 0 2087 2088 -3 0 2087 2088 -3 0 2087 2088 -3 0 2087 2088 -3 0 2087 2088 -3 0 2087 2088 -3 0 2087 2088 -3 0 2087 2088 -3 0 2087 2088 -3 0 2087 2088 -3 0 2087 2088 -3 0 2087 2088 -3 0 2087 2088 -3 0 2087 2088 -3 0 2087 2088 -3 0 2087 2088 -3 0 2087 2088 -3 0 2087 2088 -3 0 2087 2088 -3 0 2087 2088 -3 0 2087 2088 -3 0 2087 2088 -3 0 2087 2088 -3 0 2087 2088 -3 0 2087 2088 -3 0 2087 2088 -3 0 2087 2088 -3 0 2087 2088 -3 0 2087 2088 -3 0 2087 2088 -3 0 2087 2088 -3 0 2087 2088 -3 0 2087 2088 -3 0 2087 2088 -3 0 2087 2088 -3 0 2087 2088 -3 0 2087 2088 -3 0 2087 2088 -3 0 2087 2088 -3 0 2087 2088 -3 0 2087 2088 -3 0 2087 2088 -3 0 2087 2088 -3 0 2087 2088 -3 0 2087 2088 -3 0 2087 2088 -3 0 2087 2088 -3 0 2087 2088 -3 0 2087 2088 -3 0 2087 2088 -3 0 2087 2088 -3 0 2087 2088 -3 0 2087 2088 -3 0 2087 2088 -3 0 2087 2088 -3 0 2087 2088 -3 0 2087 2088 -3 0 2087 2088 -3 0 2087 2088 -3 0 2087 2088 -3 0 2087 2088 -3 0 2087 2088 -3 0 2087 2088 -3 0 2087 2088 -3 0 2087 2088 -3 0 2087 2088 -3 0 2087 2088 -3 0 2087 2088 -3 0 2087 2088 -3 0 2087 2088 -3 0 2087 2088 -3 0 2087 2088 -3 0 2087 2088 -3 0 2087 2088 -3 0 2087 2088 -3 0 2087 2088 -3 0 2087 2088 -3 0 2087 2088 -3 0 2087 2088 -3 0 2087 2088 -3 0 2087 2088 -3 0 2087 2088 -3 0 2087 2088 -3 0 2087 2088 -3 0 2087 2088 -3 0 2087 2088 -3 0 2087 2088 -3 0 2087 2088 -3 0 2087 2088 -3 0 2087 2088 -3 0 2087 2088 -3 0 2087 2088 -3 0 2087 2088 -3 0 2087 2088 -3 0 2087 2088 -3 0 2087 2088 -3 0 2087 2088 -3 0 2087 2088 -3 0 2087 2088 -3 0 2087 2088 -3 0 2087 2088 -3 0 2087 2088 -3 0 2087 2088 -3 0 2087 2088 -3 0 2087 2088 -3 0 2087 2088 -3 0 2087 2088 -3 0 2087 2088 -3 0 2087 2088 -3 0 2087 2088 -3 0 2087 2088 -3 0 2087 2088 -3 0 2087 2088 -3 0 2087 2088 -3 0 2087 2088 -3 0 2087 2088 -3 0 2087 2088 -3 0 2087 2088 -3 0 2087 2088 -3 0 2087 2088 -3 0 2087 2088 -3 0 2087 2088 -3 0 2087 2088 -3 0 2087 2088 -3 0 2087 2088 -3 0 2087 2088 -3 0 2087 2088 -3 0 2087 2088 -3 0 2087 2088 -3 0 2087 2088 -3 0 2087 2088 -3 0 2087 2088 -3 0 2087 2088 -3 0 2087 2088 -3 0 2087 2088 -3 0 2087 2088 -3 0 2087 2088 -3 0 2087 2088 -3 0 2087 2088 -3 0 2087 2088 -3 0 2087 2088 -3 0 2087 2088 -3 0 2087 2088 -3 0 2087 2088 -3 0 2087 2088 -3 0 2087 2088 -3 0 2087 2088 -3 0 2087 2088 -3 0 2087 2088 -3 0 2087 2088 -3 0 2087 2088 -3 0 2087 2088 -3 0 2087 2088 -3 0 2087 2088 -3 0 2087 2088 -3 0 2087 2088 -3 0 2087 2088 -3 0 2087 2088 -3 0 2087 2088 -3 0 2087 2088 -3 0 2087 2088 -3 0 2087 2088 -3 0 2087 2088 -3 0 2087 2088 -3 0 2087 2088 -3 0 2087 2088 -3 0 2087 2088 -3 0 2087 2088 -3 0 2087 2088 -3 0 2087 2088 -3 0 2087 2088 -3 0 2087 2088 -3 0 2087 2088 -3 0 2087 2088 -3 0 2087 2088 -3 0 2087 2088 -3 0 2087 2088 -3 0 2087 2088 -3 0 2087 2088 -3 0 2087 2088 -3 0 2087 2088 -3 0 2087 2088 -3 0 2087 2088 -3 0 2087 2088 -3 0 2087 2088 -3 0 2087 2088 -3 0 2087 2088 -3 0 2087 2088 -3 0 2087 2088 -3 0 2087 2088 -3 0 2087 2088 -3 0 2087 2088 -3 0 2087 2088 -3 0 2087 2088 -3 0 2087 2088 -3 0 2087 2088 -3 0 2087 2088 -3 0 2087 2088 -3 0 2087 2088 -3 0 2087 2088 -3 0 2087 2088 -3 0 2087 2088 -3 0 2087 2088 -3 0 2087 2088 -3 0 2087 2088 -3 0 2087 2088 -3 0 2087 2088 -3 0 2087 2088 -3 0 2087 2088 -3 0 2087 2088 -3 0 2087 2088 -3 0 2087 2088 -3 0 2087 2088 -3 0 2087 2088 -3 0 2087 2088 -3 0 2087 2088 -3 0 2087 2088 -3 0 2087 2088 -3 0 2087 2088 -3 0 2087 2088 -3 0 2087 2088 -3 0 2087 2088 -3 0 2087 2088 -3 0 2087 2088 -3 0 2087 2088 -3 0 2087 2088 -3 0 2087 2088 -3 0 2087 2088 -3 0 2087 2088 -3 0 2087 2088 -3 0 2087 2088 -3 0 2087 2088 -3 0 2087 2088 -3 0 2087 2088 -3 0 2087 2088 -3 0 2087 2088 -3 0 2087 2088 -3 0 2087 2088 -3 0 2087 2088 -3 0 2087 2088 -3 0 2087 2088 -3 0 2087 2088 -3 0 2087 2088 -3 0 2087 2088 -3 0 2087 2088 -3 0 2087 2088 -3 0 2087 2088 -3 0 2087 2088 -3 0 2087 2088 -3 0 2087 2088 -3 0 2087 2088 -3 0 2087 2088 -3 0 2087 2088 -3 0 2087 2088 -3 0 2087 2088 -3 0 2087 2088 -3 0 2087 2088 -3 0 2087 2088 -3 0 2087 2088 -3 0 2087 2088 -3 0 2087 2088 -3 0 2087 2088 -3 0 2087 2088 -3 0 2087 2088 -3 0 2087 2088 -3 0 2087 2088 -3 0 2087 2088 -3 0 2087 2088 -3 0 2087 2088 -3 0 2087 2088 -3 0 2087 2088 -3 0 2087 2088 -3 0 2087 2088 -3 0 2087 2088 -3 0 2087 2088 -3 0 2087 2088 -3 0 2087 2088 -3 0 2087 2088 -3 0 2087 2088 -3 0 2087 2088 -3 0 2087 2088 -3 0 2087 2088 -3 0 2087 2088 -3 0 2087 2088 -3 0 2087 2088 -3 0 2087 2088 -3 0 2087 2088 -3 0 2087 2088 -3 0 2087 2088 -3 0 2087 2088 -3 0 2087 2088 -3 0 2087 2088 -3 0 2087 2088 -3 0 2087 2088 -3 0 2087 2088 -3 0 2087 2088 -3 0 2087 2088 -3 0 2087 2088 -3 0 2087 2088 -3 0 2087 2088 -3 0 2087 2088 -3 0 2087 2088 -3 0 2087 2088 -3 0 2087 2088 -3 0 2087 2088 -3 0 2087 2088 -3 0 2087 2088 -3 0 2087 2088 -3 0 2087 2088 -3 0 2087 2088 -3 0 2087 2088 -3 0 2087 2088 -3 0 2087 2088 -3 0 2087 2088 -3 0 2087 2088 -3 0 2087 2088 -3 0 2087 2088 -3 0 2087 2088 -3 0 2087 2088 -3 0 2087 2088 -3 0 2087 2088 -3 0 2087 2088 -3 0 2087 2088 -3 0 2087 2088 -3 0 2087 2088 -3 0 2087 2088 -3 0 2087 2088 -3 0 2087 2088 -3 0 2087 2088 -3 0 2087 2088 -3 0 2087 2088 -3 0 2087 2088 -3 0 2087 2088 -3 0 2087 2088 -3 0 2087 2088 -3 0 2087 2088 -3 0 2087 2088 -3 0 2087 2088 -3 0 2087 2088 -3 0 2087 2088 -3 0 2087 2088 -3 0 2087 2088 -3 0 2087 2088 -3 0 2087 2088 -3 0 2087 2088 -3 0 2087 2088 -3 0 2087 2088 -3 0 2087 2088 -3 0 2087 2088 -3 0 2087 2088 -3 0 2087 2088 -3 0 2087 2088 -3 0 2087 2088 -3 0 2087 2088 -3 0 2087 2088 -3 0 2087 2088 -3 0 2087 2088 -3 0 2087 2088 -3 0 2087 2088 -3 0 2087 2088 -3 0 2087 2088 -3 0 2087 2088 -3 0 2087 2088 -3 0 2087 2088 -3 0 2087 2088 -3 0 2087 2088 -3 0 2087 2088 -3 0 2087 2088 -3 0 2087 2088 -3 0 2087 2088 -3 0 2087 2088 -3 0 2087 2088 -3 0 2087 2088 -3 0 2087 2088 -3 0 2087 2088 -3 0 2087 2088 -3 0 2087 2088 -3 0 2087 2088 -3 0 2087 2088 -3 0 2087 2088 -3 0 2087 2088 -3 0 2087 2088 -3 0 2087 2088 -3 0 2087 2088 -3 0 2087 2088 -3 0 2087 2088 -3 0 2087 2088 -3 0 2087 2088 -3 0 2087 2088 -3 0 2087 2088 -3 0 2087 2088 -3 0 2087 2088 -3 0 2087 2088 -3 0 2087 2088 -3 0 2087 2088 -3 0 2087 2088 -3 0 2087 2088 -3 0 2087 2088 -3 0 2087 2088 -3 0 2087 2088 -3 0 2087 2088 -3 0 2087 2088 -3 0 2087 2088 -3 0 2087 2088 -3 0 2087 2088 -3 0 2087 2088 -3 0 2087 2088 -3 0 2087 2088 -3 0 2087 2088 -3 0 2087 2088 -3 0 2087 2088 -3 0 2087 2088 -3 0 2087 2088 -3 0 2087 2088 -3 0 2087 2088 -3 0 2087 2088 -3 0 2087 2088 -3 0 2087 2088 -3 0 2087 2088 -3 0 2087 2088 -3 0 2087 2088 -3 0 2087 2088 -3 0 2087 2088 -3 0 2087 2088 -3 0 2087 2088 -3 0 2087 2088 -3 0 2087 2088 -3 0 2087 2088 -3 0 2087 2088 -3 0 2087 2088 -3 0 2087 2088 -3 0 2087 2088 -3 0 2087 2088 -3 0 2087 2088 -3 0 2087 2088 -3 0 2087 2088 -3 0 2087 2088 -3 0 2087 2088 -3 0 2087 2088 -3 0 2087 2088 -3 0 2087 2088 -3 0 2087 2088 -3 0 2087 2088 -3 0 2087 2088 -3 0 2087 2088 -3 0 2087 2088 -3 0 2087 2088 -3 0 2087 2088 -3 0 2087 2088 -3 0 2087 2088 -3 0 2087 2088 -3 0 2087 2088 -3 0 2087 2088 -3 0 2087 2088 -3 0 2087 2088 -3 0 2087 2088 -3 0 2087 2088 -3 0 2087 2088 -3 0 2087 2088 -3 0 2087 2088 -3 0 2087 2088 -3 0 2087 2088 -3 0 2087 2088 -3 0 2087 2088 -3 0 2087 2088 -3 0 2087 2088 -3 0 2087 2088 -3 0 2087 2088 -3 0 2087 2088 -3 0 2087 2088 -3 0 2087 2088 -3 0 2087 2088 -3 0 2087 2088 -3 0 2087 2088 -3 0 2087 2088 -3 0 2087 2088 -3 0 2087 2088 -3 0 2087 2088 -3 0 2087 2088 -3 0 2087 2088 -3 0 2087 2088 -3 0 2087 2088 -3 0 2087 2088 -3 0 2087 2088 -3 0 2087 2088 -3 0 2087 2088 -3 0 2087 2088 -3 0 2087 2088 -3 0 2087 2088 -3 0 2087 2088 -3 0 2087 2088 -3 0 2087 2088 -3 0 2087 2088 -3 0 2087 2088 -3 0 2087 2088 -3 0 2087 2088 -3 0 2087 2088 -3 0 2087 2088 -3 0 2087 2088 -3 0 2087 2088 -3 0 2087 2088 -3 0 2087 2088 -3 0 2087 2088 -3 0 2087 2088 -3 0 2087 2088 -3 0 2087 2088 -3 0 2087 2088 -3 0 2087 2088 -3 0 2087 2088 -3 0 2087 2088 -3 0 2087 2088 -3 0 2087 2088 -3 0 2087 2088 -3 0 2087 2088 -3 0 2087 2088 -3 0 2087 2088 -3 0 2087 2088 -3 0 2087 2088 -3 0 2087 2088 -3 0 2087 2088 -3 0 2087 2088 -3 0 2087 2088 -3 0 2087 2088 -3 0 2087 2088 -3 0 2087 2088 -3 0 2087 2088 -3 0 2087 2088 -3 0 2087 2088 -3 0 2087 2088 -3 0 2087 2088 -3 0 2087 2088 -3 0 2087 2088 -3 0 2087 2088 -3 0 2087 2088 -3 0 2087 2088 -3 0 2087 2088 -3 0 2087 2088 -3 0 2087 2088 -3 0 2087 2088 -3 0 2087 2088 -3 0 2087 2088 -3 0 2087 2088 -3 0 2087 2088 -3 0 2087 2088 -3 0 2087 2088 -3 0 2087 2088 -3 0 2087 2088 -3 0 2087 2088 -3 0 2087 2088 -3 0 2087 2088 -3 0 2087 2088 -3 0 2087 2088 -3 0 2087 2088 -3 0 2087 2088 -3 0 2087 2088 -3 0 2087 2088 -3 0 2087 2088 -3 0 2087 2088 -3 0 2087 2088 -3 0 2087 2088 -3 0 2087 2088 -3 0 2087 2088 -3 0 2087 2088 -3 0 2087 2088 -3 0 2087 2088 -3 0 2087 2088 -3 0 2087 2088 -3 0 2087 2088 -3 0 2087 2088 -3 0 2087 2088 -3 0 2087 2088 -3 0 2087 2088 -3 0 2087 2088 -3 0 2087 2088 -3 0 2087 2088 -3 0 2087 2088 -3 0 2087 2088 -3 0 2087 2088 -3 0 2087 2088 -3 0 2087 2088 -3 0 2087 2088 -3 0 2087 2088 -3 0 2087 2088 -3 0 2087 2088 -3 0 2087 2088 -3 0 2087 2088 -3 0 2087 2088 -3 0 2087 2088 -3 0 2087 2088 -3 0 2087 2088 -3 0 2087 2088 -3 0 2087 2088 -3 0 2087 2088 -3 0 2087 2088 -3 0 2087 2088 -3 0 2087 2088 -3 0 2087 2088 -3 0 2087 2088 -3 0 2087 2088 -3 0 2087 2088 -3 0 2087 2088 -3 0 2087 2088 -3 0 2087 2088 -3 0 2087 2088 -3 0 2087 2088 -3 0 2087 2088 -3 0 2087 2088 -3 0 2087 2088 -3 0 2087 2088 -3 0 2087 2088 -3 0 2087 2088 -3 0 2087 2088 -3 0 2087 2088 -3 0 2087 2088 -3 0 2087 2088 -3 0 2087 2088 -3 0 2087 2088 -3 0 2087 2088 -3 0 2087 2088 -3 0 2087 2088 -3 0 2087 2088 -3 0 2087 2088 -3 0 2087 2088 -3 0 2087 2088 -3 0 2087 2088 -3 0 2087 2088 -3 0 2087 2088 -3 0 2087 2088 -3 0 2087 2088 -3 0 2087 2088 -3 0 2087 2088 -3 0 2087 2088 -3 0 2087 2088 -3 0 2087 2088 -3 0 2087 2088 -3 0 2087 2088 -3 0 2087 2088 -3 0 2087 2088 -3 0 2087 2088 -3 0 2087 2088 -3 0 2087 2088 -3 0 2087 2088 -3 0 2087 2088 -3 0 2087 2088 -3 0 2087 2088 -3 0 2087 2088 -3 0 2087 2088 -3 0 2087 2088 -3 0 2087 2088 -3 0 2087 2088 -3 0 2087 2088 -3 0 2087 2088 -3 0 2087 2088 -3 0 2087 2088 -3 0 2087 2088 -3 0 2087 2088 -3 0 2087 2088 -3 0 2087 2088 -3 0 2087 2088 -3 0 2087 2088 -3 0 2087 2088 -3 0 2087 2088 -3 0 2087 2088 -3 0 2087 2088 -3 0 2087 2088 -3 0 2087 2088 -3 0 2087 2088 -3 0 2087 2088 -3 0 2087 2088 -3 0 2087 2088 -3 0 2087 2088 -3 0 2087 2088 -3 0 2087 2088 -3 0 2087 2088 -3 0 2087 2088 -3 0 2087 2088 -3 0 2087 2088 -3 0 2087 2088 -3 0 2087 2088 -3 0 2087 2088 -3 0 2087 2088 -3 0 2087 2088 -3 0 2087 2088 -3 0 2087 2088 -3 0 2087 2088 -3 0 2087 2088 -3 0 2087 2088 -3 0 2087 2088 -3 0 2087 2088 -3 0 2087 2088 -2 0)
    )
    (willowisp
      (z-pos 150)
      (color 0 1 0)
      (x 704)
      (y 736)
    )
    (willowisp
      (z-pos 150)
      (color 0 1 0)
      (x 784)
      (y 832)
    )
    (willowisp
      (z-pos 150)
      (color 0 1 0)
      (x 1184)
      (y 720)
    )
    (willowisp
      (z-pos 150)
      (color 0 1 0)
      (x 1104)
      (y 816)
    )
  )
)
