(supertux-level
  (version 3)
  (name (_ "The Sickly Sewers"))
  (author "Sophie Ball")
  (license "CC-BY-SA 4.0 International")
  (allow-item-pocket "inherit")
  (icon "")
  (icon-locked "")
  (statistics
    (enable-coins #t)
    (enable-badguys #f)
    (enable-secrets #t)
  )
  (sector
    (name "main")
    (init-script "Tux.set_visible(false);
Tux.deactivate();")
    (ambient-light
      (color 0.5 0.5 0.5)
    )
    (background
      (color 0.3 0.3 0.3)
      (speed 0.2)
      (image "/images/background/sewers/browncave2.png")
    )
    (background
      (color 0.3764706 0.254902 0)
      (scroll-speed-x -50)
      (speed 0.5)
      (image "/images/background/misc/fog.png")
      (z-pos 300)
    )
    (background
      (color 1 1 1)
      (speed 0)
      (fill #t)
      (image "/images/background/misc/vignette.png")
      (z-pos 301)
    )
    (camera
      (name "Camera")
      (mode "normal")
    )
    (gradient
      (top_color 0.3 0.4 0.75)
      (bottom_color 1 1 1)
      (z-pos -301)
    )
    (music
      (file "/music/present/halloween_1.music")
    )
    (particles-ghosts
    )
    (scripttrigger
      (script "Tux.set_visible(true);")
      (button #f)
      (width 64)
      (height 32)
      (x 96)
      (y 512)
    )
    (scripttrigger
      (oneshot #t)
      (script "wait(0.5);
Text.set_font(\"normal\");

Text.set_text(\"Tux had gone to Sickly Sewers Zone, and he saw that it was very unfinished.\");
Text.fade_in(1);
wait(4);
Text.fade_out(1);
wait(1);

Text.set_text(\"Even worse, the smell was already hurting him...\");
Text.fade_in(1);
wait(4);
Text.fade_out(1);
wait(1);

Tux.walk(350);
Text.set_text(\"Tux needed to get out as soon as possible.\");
Text.fade_in(1);
wait(4);
Text.fade_out(1);
wait(1);")
      (button #f)
      (width 32)
      (height 32)
      (x 112)
      (y 928)
    )
    (scripttrigger
      (script "Tux.do_jump(-700);")
      (button #f)
      (width 32)
      (height 32)
      (x 640)
      (y 928)
    )
    (scripttrigger
      (script "Effect.fade_out(2);
wait(2);
Level.finish(true);")
      (button #f)
      (width 32)
      (height 32)
      (x 1008)
      (y 768)
    )
    (scripttrigger
      (script "Tux.do_jump(-400);")
      (button #f)
      (width 32)
      (height 32)
      (x 1536)
      (y 928)
    )
    (spawnpoint
      (name "main")
      (x 112)
      (y 32)
    )
    (spawnpoint
      (x 480)
      (y 896)
    )
    (tilemap
      (solid #f)
      (z-pos -100)
      (width 100)
      (height 35)
      (tiles -3500 0)
    )
    (tilemap
      (solid #f)
      (z-pos 100)
      (width 100)
      (height 35)
      (tiles -3 0 2087 2088 -98 0 2087 2088 -98 0 2087 2088 -98 0 2087 2088 -98 0 2087 2088 -98 0 2087 2088 -98 0 2087 2088 -98 0 2087 2088 -98 0 2087 2088 -98 0 2087 2088 -98 0 2087 2088 -98 0 2087 2088 -98 0 2087 2088 -98 0 2087 2088 -98 0 2087 2088 -98 0 2089 2090 -1595 0 4553 4554 4555 4556 4553 4554 4555 4556 4553 4554 4555 4556 4553 4554 4555 4556 4553 4554 4555 4556 4553 4554 4555 4556 4553 4554 4555 4556 4553 4554 4555 4556 4553 4554 4555 4556 4553 4554 4555 4556 4553 4554 4555 4556 4553 4554 4555 4556 4553 4554 4555 4556 4553 4554 4555 4556 4553 4554 4555 4556 4553 4554 4555 4556 4553 4554 4555 4556 4553 4554 4555 4556 4553 4554 4555 4556 4553 4554 4555 4556 4553 4554 4555 4556 4553 4554 4555 4556 4553 4554 4555 4556 4553 4554 4555 4556 4553 4554 4555 4556 -300 4557)
    )
    (tilemap
      (solid #t)
      (z-pos 0)
      (width 100)
      (height 35)
      (tiles -2 4633 4634 -2 0 -34 4633 4634 -60 0 -2 4633 4634 -2 0 -34 4633 4634 -60 0 -2 4633 4634 -2 0 -34 4633 4634 -60 0 -2 4633 4634 -2 0 -34 4633 4634 -60 0 -2 4633 4634 -2 0 -34 4633 4634 -60 0 -2 4633 4634 -2 0 -34 4633 4634 -60 0 -2 4633 4634 -2 0 -34 4633 4634 -60 0 -2 4633 4634 -2 0 -34 4633 4634 -60 0 -2 4633 4634 -2 0 -34 4633 4634 -60 0 -2 4633 4634 -2 0 -34 4633 4634 -60 0 -2 4633 4634 -2 0 -34 4633 4634 -60 0 -2 4633 4634 -2 0 -34 4633 4634 -60 0 -2 4633 4634 -2 0 -34 4633 4634 -60 0 -2 4633 4634 -2 0 -16 4633 4649 -17 4637 4638 -60 0 -2 4633 4634 -2 0 -16 4633 4634 -78 0 -2 4637 4638 -2 0 -16 4637 4638 -1008 0 4640 -2 4641 4642 -94 0 4640 -2 4641 4642 4640 -2 4641 4642 -25 0 2085 2086 -63 0 4640 -2 4641 4642 4640 -2 4641 4642 4640 -2 4641 4642 -23 0 2087 2088 -61 0 4640 -2 4641 4642 4640 -2 4641 4642 4640 -2 4641 4642 4640 -2 4641 4642 -13 0 2085 2086 -6 0 2087 2088 -6 0 2085 2086 0 2085 2086 -4 0 2085 2086 -42 0 4640 -2 4641 4642 4640 -2 4641 4642 4640 -2 4641 4642 4640 -2 4641 4642 4640 -2 4641 4642 -11 0 2087 2088 -6 0 2087 2088 -6 0 2087 2088 0 2087 2088 -4 0 2087 2088 -20 0 -100 4629 -5 4633 -7 4645 4646 4648 -10 4645 -4 4633 4648 -10 4633 -3 4647 -14 4633 4648 -9 4633 4648 -5 4633 -6 4647 -25 4633 4646 -2 4645 -8 4633 -11 4647 4646 -8 4633 4646 -2 4647 4646 -3 4647 4633 4645 4648 -4 4645 -2 4633 -5 4647 -12 4645 4646 -2 4633 -3 4647 -2 4633 -7 4647 -7 4633 -2 4647 4648 4646 -3 4647 4648 4647 -5 4633 -2 4645 4646 4645 -3 4633 -4 4645 4647 4646 -5 4645 4648 4633 4647 4645 -6 4633 -9 4647 4633 -4 4645 4646 -2 4645 -5 4633 4646 -6 4647 -4 4645 4633 4645 -3 4633 -8 4647 -4 4633 -2 4648 -6 4633 -10 4647 -7 4633 -7 4645 -2 4647 -6 4645 -3 4647 -9 4633 4647 4648 -3 4647 -2 4633 -2 4645 -5 4633 -6 4645 4648 -3 4645 4647 4645 -4 4647 -8 4633 4648 -3 4633 4646 -13 4633 4647 -2 4633 4648 4647 -2 4633 -3 4647 4633)
    )
    (tilemap
      (solid #f)
      (speed-x 0.5)
      (speed-y 0.5)
      (tint 0.5 0.5 0.5)
      (z-pos -299)
      (width 100)
      (height 35)
      (tiles -3 0 2087 2088 -3 0 2087 2088 -3 0 2087 2088 -3 0 2087 2088 -3 0 2087 2088 -3 0 2087 2088 -3 0 2087 2088 -3 0 2087 2088 -3 0 2087 2088 -3 0 2087 2088 -3 0 2087 2088 -3 0 2087 2088 -3 0 2087 2088 -3 0 2087 2088 -3 0 2087 2088 -3 0 2087 2088 -3 0 2087 2088 -3 0 2087 2088 -3 0 2087 2088 -3 0 2087 2088 -3 0 2087 2088 -3 0 2087 2088 -3 0 2087 2088 -3 0 2087 2088 -3 0 2087 2088 -3 0 2087 2088 -3 0 2087 2088 -3 0 2087 2088 -3 0 2087 2088 -3 0 2087 2088 -3 0 2087 2088 -3 0 2087 2088 -3 0 2087 2088 -3 0 2087 2088 -3 0 2087 2088 -3 0 2087 2088 -3 0 2087 2088 -3 0 2087 2088 -3 0 2087 2088 -3 0 2087 2088 -3 0 2087 2088 -3 0 2087 2088 -3 0 2087 2088 -3 0 2087 2088 -3 0 2087 2088 -3 0 2087 2088 -3 0 2087 2088 -3 0 2087 2088 -3 0 2087 2088 -3 0 2087 2088 -3 0 2087 2088 -3 0 2087 2088 -3 0 2087 2088 -3 0 2087 2088 -3 0 2087 2088 -3 0 2087 2088 -3 0 2087 2088 -3 0 2087 2088 -3 0 2087 2088 -3 0 2087 2088 -3 0 2087 2088 -3 0 2087 2088 -3 0 2087 2088 -3 0 2087 2088 -3 0 2087 2088 -3 0 2087 2088 -3 0 2087 2088 -3 0 2087 2088 -3 0 2087 2088 -3 0 2087 2088 -3 0 2087 2088 -3 0 2087 2088 -3 0 2087 2088 -3 0 2087 2088 -3 0 2087 2088 -3 0 2087 2088 -3 0 2087 2088 -3 0 2087 2088 -3 0 2087 2088 -3 0 2087 2088 -3 0 2087 2088 -3 0 2087 2088 -3 0 2087 2088 -3 0 2087 2088 -3 0 2087 2088 -3 0 2087 2088 -3 0 2087 2088 -3 0 2087 2088 -3 0 2087 2088 -3 0 2087 2088 -3 0 2087 2088 -3 0 2087 2088 -3 0 2087 2088 -3 0 2087 2088 -3 0 2087 2088 -3 0 2087 2088 -3 0 2087 2088 -3 0 2087 2088 -3 0 2087 2088 -3 0 2087 2088 -3 0 2087 2088 -3 0 2087 2088 -3 0 2087 2088 -3 0 2087 2088 -3 0 2087 2088 -3 0 2087 2088 -3 0 2087 2088 -3 0 2087 2088 -3 0 2087 2088 -3 0 2087 2088 -3 0 2087 2088 -3 0 2087 2088 -3 0 2087 2088 -3 0 2087 2088 -3 0 2087 2088 -3 0 2087 2088 -3 0 2087 2088 -3 0 2087 2088 -3 0 2087 2088 -3 0 2087 2088 -3 0 2087 2088 -3 0 2087 2088 -3 0 2087 2088 -3 0 2087 2088 -3 0 2087 2088 -3 0 2087 2088 -3 0 2087 2088 -3 0 2087 2088 -3 0 2087 2088 -3 0 2087 2088 -3 0 2087 2088 -3 0 2087 2088 -3 0 2087 2088 -3 0 2087 2088 -3 0 2087 2088 -3 0 2087 2088 -3 0 2087 2088 -3 0 2087 2088 -3 0 2087 2088 -3 0 2087 2088 -3 0 2087 2088 -3 0 2087 2088 -3 0 2087 2088 -3 0 2087 2088 -3 0 2087 2088 -3 0 2087 2088 -3 0 2087 2088 -3 0 2087 2088 -3 0 2087 2088 -3 0 2087 2088 -3 0 2087 2088 -3 0 2087 2088 -3 0 2087 2088 -3 0 2087 2088 -3 0 2087 2088 -3 0 2087 2088 -3 0 2087 2088 -3 0 2087 2088 -3 0 2087 2088 -3 0 2087 2088 -3 0 2087 2088 -3 0 2087 2088 -3 0 2087 2088 -3 0 2087 2088 -3 0 2087 2088 -3 0 2087 2088 -3 0 2087 2088 -3 0 2087 2088 -3 0 2087 2088 -3 0 2087 2088 -3 0 2087 2088 -3 0 2087 2088 -3 0 2087 2088 -3 0 2087 2088 -3 0 2087 2088 -3 0 2087 2088 -3 0 2087 2088 -3 0 2087 2088 -3 0 2087 2088 -3 0 2087 2088 -3 0 2087 2088 -3 0 2087 2088 -3 0 2087 2088 -3 0 2087 2088 -3 0 2087 2088 -3 0 2087 2088 -3 0 2087 2088 -3 0 2087 2088 -3 0 2087 2088 -3 0 2087 2088 -3 0 2087 2088 -3 0 2087 2088 -3 0 2087 2088 -3 0 2087 2088 -3 0 2087 2088 -3 0 2087 2088 -3 0 2087 2088 -3 0 2087 2088 -3 0 2087 2088 -3 0 2087 2088 -3 0 2087 2088 -3 0 2087 2088 -3 0 2087 2088 -3 0 2087 2088 -3 0 2087 2088 -3 0 2087 2088 -3 0 2087 2088 -3 0 2087 2088 -3 0 2087 2088 -3 0 2087 2088 -3 0 2087 2088 -3 0 2087 2088 -3 0 2087 2088 -3 0 2087 2088 -3 0 2087 2088 -3 0 2087 2088 -3 0 2087 2088 -3 0 2087 2088 -3 0 2087 2088 -3 0 2087 2088 -3 0 2087 2088 -3 0 2087 2088 -3 0 2087 2088 -3 0 2087 2088 -3 0 2087 2088 -3 0 2087 2088 -3 0 2087 2088 -3 0 2087 2088 -3 0 2087 2088 -3 0 2087 2088 -3 0 2087 2088 -3 0 2087 2088 -3 0 2087 2088 -3 0 2087 2088 -3 0 2087 2088 -3 0 2087 2088 -3 0 2087 2088 -3 0 2087 2088 -3 0 2087 2088 -3 0 2087 2088 -3 0 2087 2088 -3 0 2087 2088 -3 0 2087 2088 -3 0 2087 2088 -3 0 2087 2088 -3 0 2087 2088 -3 0 2087 2088 -3 0 2087 2088 -3 0 2087 2088 -3 0 2087 2088 -3 0 2087 2088 -3 0 2087 2088 -3 0 2087 2088 -3 0 2087 2088 -3 0 2087 2088 -3 0 2087 2088 -3 0 2087 2088 -3 0 2087 2088 -3 0 2087 2088 -3 0 2087 2088 -3 0 2087 2088 -3 0 2087 2088 -3 0 2087 2088 -3 0 2087 2088 -3 0 2087 2088 -3 0 2087 2088 -3 0 2087 2088 -3 0 2087 2088 -3 0 2087 2088 -3 0 2087 2088 -3 0 2087 2088 -3 0 2087 2088 -3 0 2087 2088 -3 0 2087 2088 -3 0 2087 2088 -3 0 2087 2088 -3 0 2087 2088 -3 0 2087 2088 -3 0 2087 2088 -3 0 2087 2088 -3 0 2087 2088 -3 0 2087 2088 -3 0 2087 2088 -3 0 2087 2088 -3 0 2087 2088 -3 0 2087 2088 -3 0 2087 2088 -3 0 2087 2088 -3 0 2087 2088 -3 0 2087 2088 -3 0 2087 2088 -3 0 2087 2088 -3 0 2087 2088 -3 0 2087 2088 -3 0 2087 2088 -3 0 2087 2088 -3 0 2087 2088 -3 0 2087 2088 -3 0 2087 2088 -3 0 2087 2088 -3 0 2087 2088 -3 0 2087 2088 -3 0 2087 2088 -3 0 2087 2088 -3 0 2087 2088 -3 0 2087 2088 -3 0 2087 2088 -3 0 2087 2088 -3 0 2087 2088 -3 0 2087 2088 -3 0 2087 2088 -3 0 2087 2088 -3 0 2087 2088 -3 0 2087 2088 -3 0 2087 2088 -3 0 2087 2088 -3 0 2087 2088 -3 0 2087 2088 -3 0 2087 2088 -3 0 2087 2088 -3 0 2087 2088 -3 0 2087 2088 -3 0 2087 2088 -3 0 2087 2088 -3 0 2087 2088 -3 0 2087 2088 -3 0 2087 2088 -3 0 2087 2088 -3 0 2087 2088 -3 0 2087 2088 -3 0 2087 2088 -3 0 2087 2088 -3 0 2087 2088 -3 0 2087 2088 -3 0 2087 2088 -3 0 2087 2088 -3 0 2087 2088 -3 0 2087 2088 -3 0 2087 2088 -3 0 2087 2088 -3 0 2087 2088 -3 0 2087 2088 -3 0 2087 2088 -3 0 2087 2088 -3 0 2087 2088 -3 0 2087 2088 -3 0 2087 2088 -3 0 2087 2088 -3 0 2087 2088 -3 0 2087 2088 -3 0 2087 2088 -3 0 2087 2088 -3 0 2087 2088 -3 0 2087 2088 -3 0 2087 2088 -3 0 2087 2088 -3 0 2087 2088 -3 0 2087 2088 -3 0 2087 2088 -3 0 2087 2088 -3 0 2087 2088 -3 0 2087 2088 -3 0 2087 2088 -3 0 2087 2088 -3 0 2087 2088 -3 0 2087 2088 -3 0 2087 2088 -3 0 2087 2088 -3 0 2087 2088 -3 0 2087 2088 -3 0 2087 2088 -3 0 2087 2088 -3 0 2087 2088 -3 0 2087 2088 -3 0 2087 2088 -3 0 2087 2088 -3 0 2087 2088 -3 0 2087 2088 -3 0 2087 2088 -3 0 2087 2088 -3 0 2087 2088 -3 0 2087 2088 -3 0 2087 2088 -3 0 2087 2088 -3 0 2087 2088 -3 0 2087 2088 -3 0 2087 2088 -3 0 2087 2088 -3 0 2087 2088 -3 0 2087 2088 -3 0 2087 2088 -3 0 2087 2088 -3 0 2087 2088 -3 0 2087 2088 -3 0 2087 2088 -3 0 2087 2088 -3 0 2087 2088 -3 0 2087 2088 -3 0 2087 2088 -3 0 2087 2088 -3 0 2087 2088 -3 0 2087 2088 -3 0 2087 2088 -3 0 2087 2088 -3 0 2087 2088 -3 0 2087 2088 -3 0 2087 2088 -3 0 2087 2088 -3 0 2087 2088 -3 0 2087 2088 -3 0 2087 2088 -3 0 2087 2088 -3 0 2087 2088 -3 0 2087 2088 -3 0 2087 2088 -3 0 2087 2088 -3 0 2087 2088 -3 0 2087 2088 -3 0 2087 2088 -3 0 2087 2088 -3 0 2087 2088 -3 0 2087 2088 -3 0 2087 2088 -3 0 2087 2088 -3 0 2087 2088 -3 0 2087 2088 -3 0 2087 2088 -3 0 2087 2088 -3 0 2087 2088 -3 0 2087 2088 -3 0 2087 2088 -3 0 2087 2088 -3 0 2087 2088 -3 0 2087 2088 -3 0 2087 2088 -3 0 2087 2088 -3 0 2087 2088 -3 0 2087 2088 -3 0 2087 2088 -3 0 2087 2088 -3 0 2087 2088 -3 0 2087 2088 -3 0 2087 2088 -3 0 2087 2088 -3 0 2087 2088 -3 0 2087 2088 -3 0 2087 2088 -3 0 2087 2088 -3 0 2087 2088 -3 0 2087 2088 -3 0 2087 2088 -3 0 2087 2088 -3 0 2087 2088 -3 0 2087 2088 -3 0 2087 2088 -3 0 2087 2088 -3 0 2087 2088 -3 0 2087 2088 -3 0 2087 2088 -3 0 2087 2088 -3 0 2087 2088 -3 0 2087 2088 -3 0 2087 2088 -3 0 2087 2088 -3 0 2087 2088 -3 0 2087 2088 -3 0 2087 2088 -3 0 2087 2088 -3 0 2087 2088 -3 0 2087 2088 -3 0 2087 2088 -3 0 2087 2088 -3 0 2087 2088 -3 0 2087 2088 -3 0 2087 2088 -3 0 2087 2088 -3 0 2087 2088 -3 0 2087 2088 -3 0 2087 2088 -3 0 2087 2088 -3 0 2087 2088 -3 0 2087 2088 -3 0 2087 2088 -3 0 2087 2088 -3 0 2087 2088 -3 0 2087 2088 -3 0 2087 2088 -3 0 2087 2088 -3 0 2087 2088 -3 0 2087 2088 -3 0 2087 2088 -3 0 2087 2088 -3 0 2087 2088 -3 0 2087 2088 -3 0 2087 2088 -3 0 2087 2088 -3 0 2087 2088 -3 0 2087 2088 -3 0 2087 2088 -3 0 2087 2088 -3 0 2087 2088 -3 0 2087 2088 -3 0 2087 2088 -3 0 2087 2088 -3 0 2087 2088 -3 0 2087 2088 -3 0 2087 2088 -3 0 2087 2088 -3 0 2087 2088 -3 0 2087 2088 -3 0 2087 2088 -3 0 2087 2088 -3 0 2087 2088 -3 0 2087 2088 -3 0 2087 2088 -3 0 2087 2088 -3 0 2087 2088 -3 0 2087 2088 -3 0 2087 2088 -3 0 2087 2088 -3 0 2087 2088 -3 0 2087 2088 -3 0 2087 2088 -3 0 2087 2088 -3 0 2087 2088 -3 0 2087 2088 -3 0 2087 2088 -3 0 2087 2088 -3 0 2087 2088 -3 0 2087 2088 -3 0 2087 2088 -3 0 2087 2088 -3 0 2087 2088 -3 0 2087 2088 -3 0 2087 2088 -3 0 2087 2088 -3 0 2087 2088 -3 0 2087 2088 -3 0 2087 2088 -3 0 2087 2088 -3 0 2087 2088 -3 0 2087 2088 -3 0 2087 2088 -3 0 2087 2088 -3 0 2087 2088 -3 0 2087 2088 -3 0 2087 2088 -3 0 2087 2088 -3 0 2087 2088 -3 0 2087 2088 -3 0 2087 2088 -3 0 2087 2088 -3 0 2087 2088 -3 0 2087 2088 -3 0 2087 2088 -3 0 2087 2088 -3 0 2087 2088 -3 0 2087 2088 -3 0 2087 2088 -3 0 2087 2088 -3 0 2087 2088 -3 0 2087 2088 -3 0 2087 2088 -3 0 2087 2088 -3 0 2087 2088 -3 0 2087 2088 -3 0 2087 2088 -3 0 2087 2088 -3 0 2087 2088 -3 0 2087 2088 -3 0 2087 2088 -3 0 2087 2088 -3 0 2087 2088 -3 0 2087 2088 -3 0 2087 2088 -3 0 2087 2088 -3 0 2087 2088 -3 0 2087 2088 -3 0 2087 2088 -3 0 2087 2088 -3 0 2087 2088 -3 0 2087 2088 -3 0 2087 2088 -3 0 2087 2088 -3 0 2087 2088 -3 0 2087 2088 -3 0 2087 2088 -3 0 2087 2088 -3 0 2087 2088 -3 0 2087 2088 -3 0 2087 2088 -3 0 2087 2088 -3 0 2087 2088 -3 0 2087 2088 -3 0 2087 2088 -3 0 2087 2088 -3 0 2087 2088 -3 0 2087 2088 -3 0 2087 2088 -3 0 2087 2088 -3 0 2087 2088 -3 0 2087 2088 -3 0 2087 2088 -3 0 2087 2088 -3 0 2087 2088 -3 0 2087 2088 -3 0 2087 2088 -3 0 2087 2088 -3 0 2087 2088 -3 0 2087 2088 -3 0 2087 2088 -3 0 2087 2088 -3 0 2087 2088 -3 0 2087 2088 -3 0 2087 2088 -3 0 2087 2088 -3 0 2087 2088 -3 0 2087 2088 -3 0 2087 2088 -3 0 2087 2088 -3 0 2087 2088 -3 0 2087 2088 -3 0 2087 2088 -3 0 2087 2088 -3 0 2087 2088 -3 0 2087 2088 -3 0 2087 2088 -3 0 2087 2088 -3 0 2087 2088 -3 0 2087 2088 -3 0 2087 2088 -3 0 2087 2088 -3 0 2087 2088 -3 0 2087 2088 -3 0 2087 2088 -3 0 2087 2088 -3 0 2087 2088 -3 0 2087 2088 -3 0 2087 2088 -3 0 2087 2088 -3 0 2087 2088 -3 0 2087 2088 -3 0 2087 2088 -3 0 2087 2088 -3 0 2087 2088 -3 0 2087 2088 -3 0 2087 2088 -3 0 2087 2088 -3 0 2087 2088 -3 0 2087 2088 -3 0 2087 2088 -3 0 2087 2088 -3 0 2087 2088 -3 0 2087 2088 -3 0 2087 2088 -3 0 2087 2088 -3 0 2087 2088 -3 0 2087 2088 -3 0 2087 2088 -3 0 2087 2088 -3 0 2087 2088 -3 0 2087 2088 -3 0 2087 2088 -3 0 2087 2088 -3 0 2087 2088 -3 0 2087 2088 -3 0 2087 2088 -3 0 2087 2088 -3 0 2087 2088 -3 0 2087 2088 -3 0 2087 2088 -3 0 2087 2088 -3 0 2087 2088 -3 0 2087 2088 -3 0 2087 2088 -3 0 2087 2088 -3 0 2087 2088 -3 0 2087 2088 -3 0 2087 2088 -3 0 2087 2088 -3 0 2087 2088 -3 0 2087 2088 -3 0 2087 2088 -3 0 2087 2088 -3 0 2087 2088 -3 0 2087 2088 -3 0 2087 2088 -3 0 2087 2088 -3 0 2087 2088 -3 0 2087 2088 -3 0 2087 2088 -3 0 2087 2088 -3 0 2087 2088 -3 0 2087 2088 -3 0 2087 2088 -3 0 2087 2088 -3 0 2087 2088 -3 0 2087 2088 -3 0 2087 2088 -3 0 2087 2088)
    )
    (torch
      (z-pos 0)
      (x 384)
      (y 864)
    )
    (torch
      (sprite "/images/objects/torch/torch2.sprite")
      (z-pos 0)
      (x 1824)
      (y 864)
    )
    (torch
      (z-pos 0)
      (x 1056)
      (y 704)
    )
  )
)
