(supertux-level
  (version 3)
  (name (_ "Rocks And Bones"))
  (author "Sophie Ball")
  (note (_ "Act 2"))
  (license "CC-BY-SA 4.0 International")
  (target-time 68)
  (allow-item-pocket "inherit")
  (icon "")
  (icon-locked "")
  (statistics
    (enable-coins #t)
    (enable-badguys #f)
    (enable-secrets #t)
  )
  (sector
    (name "main")
    (ambient-light
      (color 1 1 1)
    )
    (background
      (scroll-offset-y 350)
      (color 1 1 1)
      (alignment "bottom")
      (speed 0.2)
      (image "/images/background/desert/arcticmountains.png")
    )
    (background
      (scroll-offset-x -300)
      (scroll-offset-y -350)
      (color 1 1 1)
      (speed 0)
      (image "/images/background/desert/sun.png")
      (z-pos -301)
    )
    (background
      (color 1 1 1 0.3)
      (speed 1)
      (image "/images/decal/misc/heatshimmer.sprite")
      (z-pos 301)
    )
    (bonusblock
      (type "orange")
      (z-pos 51)
      (x 8960)
      (y 832)
    )
    (camera
      (name "Camera")
      (mode "normal")
    )
    (captainsnowball
      (z-pos 50)
      (x 896)
      (y 1600)
    )
    (captainsnowball
      (z-pos 50)
      (x 1920)
      (y 1440)
    )
    (captainsnowball
      (z-pos 50)
      (x 2304)
      (y 1312)
    )
    (captainsnowball
      (z-pos 50)
      (x 2720)
      (y 1184)
    )
    (captainsnowball
      (z-pos 50)
      (x 1536)
      (y 1568)
    )
    (captainsnowball
      (z-pos 50)
      (x 3776)
      (y 1344)
    )
    (captainsnowball
      (z-pos 50)
      (x 4384)
      (y 1280)
    )
    (captainsnowball
      (z-pos 50)
      (x 4992)
      (y 1216)
    )
    (captainsnowball
      (z-pos 50)
      (x 8736)
      (y 1824)
    )
    (captainsnowball
      (z-pos 50)
      (x 8960)
      (y 1792)
    )
    (captainsnowball
      (z-pos 50)
      (x 14016)
      (y 672)
    )
    (captainsnowball
      (z-pos 50)
      (x 6592)
      (y 1632)
    )
    (captainsnowball
      (z-pos 50)
      (x 6304)
      (y 1600)
    )
    (captainsnowball
      (z-pos 50)
      (x 5984)
      (y 1536)
    )
    (captainsnowball
      (z-pos 50)
      (x 5728)
      (y 1504)
    )
    (climbable
      (width 32)
      (height 736)
      (x 9056)
      (y 1152)
    )
    (decal
      (z-pos -99)
      (sprite "/images/decal/forest/ghost-bush-1.png")
      (x 288)
      (y 1536)
    )
    (decal
      (z-pos -99)
      (sprite "/images/decal/forest/ghost-bush-1.png")
      (x 1344)
      (y 1504)
    )
    (decal
      (z-pos -99)
      (sprite "/images/decal/forest/ghost-bush-1.png")
      (x 2048)
      (y 1248)
    )
    (decal
      (z-pos -99)
      (sprite "/images/decal/forest/ghost-bush-1.png")
      (x 2656)
      (y 1120)
    )
    (decal
      (z-pos -99)
      (sprite "/images/decal/forest/ghost-bush-1.png")
      (x 3552)
      (y 1280)
    )
    (decal
      (z-pos -99)
      (sprite "/images/decal/forest/ghost-bush-1.png")
      (x 5216)
      (y 1408)
    )
    (decal
      (z-pos -99)
      (sprite "/images/decal/forest/ghost-bush-1.png")
      (x 7232)
      (y 1696)
    )
    (decal
      (z-pos -99)
      (sprite "/images/decal/forest/ghost-bush-1.png")
      (x 8512)
      (y 1760)
    )
    (decal
      (z-pos -99)
      (sprite "/images/decal/forest/ghost-bush-1.png")
      (x 9152)
      (y 1376)
    )
    (decal
      (z-pos -99)
      (sprite "/images/decal/forest/ghost-bush-1.png")
      (x 8672)
      (y 864)
    )
    (decal
      (z-pos -99)
      (sprite "/images/decal/forest/ghost-bush-1.png")
      (x 9472)
      (y 384)
    )
    (decal
      (z-pos -99)
      (sprite "/images/decal/forest/ghost-bush-1.png")
      (x 12928)
      (y 608)
    )
    (decal
      (z-pos -99)
      (sprite "/images/decal/forest/ghost-bush-1.png")
      (x 14208)
      (y 640)
    )
    (decal
      (z-pos -99)
      (sprite "/images/decal/forest/ghost-bush-1.png")
      (x 15520)
      (y 672)
    )
    (decal
      (z-pos -99)
      (sprite "/images/decal/forest/ghost-bush-1.png")
      (x 14944)
      (y 672)
    )
    (gradient
      (top_color 0.3 0.4 0.75)
      (bottom_color 1 1 1)
      (z-pos -302)
    )
    (gradient
      (top_color 1 0.9882353 0.7529412 0.2)
      (bottom_color 1 0.9058824 0.3686275 0.1)
      (z-pos 300)
    )
    (haywire
      (z-pos 50)
      (x 8928)
      (y 1440)
    )
    (jumpy
      (type "wooden")
      (z-pos 50)
      (x 6848)
      (y 1632)
    )
    (jumpy
      (type "wooden")
      (z-pos 50)
      (x 7200)
      (y 1696)
    )
    (jumpy
      (type "wooden")
      (z-pos 50)
      (x 7552)
      (y 1760)
    )
    (jumpy
      (type "wooden")
      (z-pos 50)
      (x 8192)
      (y 1792)
    )
    (jumpy
      (type "wooden")
      (z-pos 50)
      (x 7968)
      (y 1824)
    )
    (jumpy
      (type "wooden")
      (z-pos 50)
      (x 8352)
      (y 608)
    )
    (jumpy
      (type "wooden")
      (z-pos 50)
      (x 9088)
      (y 416)
    )
    (jumpy
      (type "wooden")
      (z-pos 50)
      (x 12960)
      (y 640)
    )
    (jumpy
      (type "wooden")
      (z-pos 50)
      (x 10720)
      (y 288)
    )
    (jumpy
      (type "wooden")
      (z-pos 50)
      (x 9280)
      (y 896)
    )
    (livefire
      (z-pos 50)
      (x 9728)
      (y 1440)
    )
    (livefire
      (z-pos 50)
      (x 8672)
      (y 928)
    )
    (music
      (file "/music/present/saharan_penguin.music")
    )
    (path
      (name "gen1740104089135333713172208")
      (path
        (adapt_speed #t)
        (node
          (x 11200)
          (y 352)
          (time 20)
        )
        (node
          (x 12800)
          (y 704)
          (time 20)
        )
      )
    )
    (platform
      (z-pos 50)
      (handle
        (scale_x 0)
        (scale_y 0)
        (offset_x 0)
        (offset_y 0)
      )
      (running #f)
      (path-ref "gen1740104089135333713172208")
    )
    (sequencetrigger
      (sequence "endsequence")
      (width 32)
      (height 832)
      (x 14656)
      (y -64)
    )
    (spawnpoint
      (name "main")
      (x 64)
      (y 1536)
    )
    (spawnpoint
      (x 10976)
      (y 288)
    )
    (spawnpoint
      (x 8800)
      (y 544)
    )
    (spawnpoint
      (x 624)
      (y 1603)
    )
    (stalactite
      (type "rock")
      (z-pos -1)
      (sprite "/images/creatures/stalactite/stalactite_coconut.sprite")
      (x 1040)
      (y 1440)
    )
    (stalactite
      (type "rock")
      (z-pos -1)
      (sprite "/images/creatures/stalactite/stalactite_rock.sprite")
      (x 2128)
      (y 1152)
    )
    (stalactite
      (type "rock")
      (z-pos -1)
      (sprite "/images/creatures/stalactite/stalactite_coconut.sprite")
      (x 3696)
      (y 1184)
    )
    (stalactite
      (type "rock")
      (z-pos -1)
      (sprite "/images/creatures/stalactite/stalactite_coconut.sprite")
      (x 4688)
      (y 1056)
    )
    (stalactite
      (type "rock")
      (z-pos -1)
      (sprite "/images/creatures/stalactite/stalactite_coconut.sprite")
      (x 8368)
      (y 480)
    )
    (stalactite
      (type "rock")
      (z-pos -1)
      (sprite "/images/creatures/stalactite/stalactite_coconut.sprite")
      (x 8336)
      (y 480)
    )
    (stalactite
      (type "rock")
      (z-pos -1)
      (sprite "/images/creatures/stalactite/stalactite_coconut.sprite")
      (x 12976)
      (y 512)
    )
    (stalactite
      (type "rock")
      (z-pos -1)
      (sprite "/images/creatures/stalactite/stalactite_coconut.sprite")
      (x 4176)
      (y 1120)
    )
    (stalactite
      (type "rock")
      (z-pos -1)
      (sprite "/images/creatures/stalactite/stalactite_coconut.sprite")
      (x 5744)
      (y 1344)
    )
    (stalactite
      (type "rock")
      (z-pos -1)
      (sprite "/images/creatures/stalactite/stalactite_coconut.sprite")
      (x 7536)
      (y 1632)
    )
    (stalactite
      (type "rock")
      (z-pos -1)
      (sprite "/images/creatures/stalactite/stalactite_coconut.sprite")
      (x 7984)
      (y 1696)
    )
    (stalactite
      (type "rock")
      (z-pos -1)
      (sprite "/images/creatures/stalactite/stalactite_coconut.sprite")
      (x 8848)
      (y 1280)
    )
    (stalactite
      (type "rock")
      (z-pos -1)
      (sprite "/images/creatures/stalactite/stalactite_coconut.sprite")
      (x 9200)
      (y 1632)
    )
    (stalactite
      (type "rock")
      (z-pos -1)
      (sprite "/images/creatures/stalactite/stalactite_coconut.sprite")
      (x 9232)
      (y 288)
    )
    (stalactite
      (type "rock")
      (z-pos -1)
      (sprite "/images/creatures/stalactite/stalactite_coconut.sprite")
      (x 10224)
      (y 160)
    )
    (stalactite
      (type "rock")
      (z-pos -1)
      (sprite "/images/creatures/stalactite/stalactite_coconut.sprite")
      (x 13840)
      (y 512)
    )
    (tilemap
      (solid #f)
      (z-pos -100)
      (width 500)
      (height 65)
      (tiles -2318 0 4723 4724 4725 -497 0 4726 4727 4728 -497 0 4729 4730 4731 -497 0 4732 4733 4734 -467 0 4723 4724 4725 -7 0 4723 4724 4725 -17 0 4735 4736 4737 -467 0 4726 4727 4728 -7 0 4726 4727 4728 -14 0 2533 2534 2539 2540 4739 4740 -467 0 4729 4730 4731 -7 0 4729 4730 4731 -12 0 2516 2517 2541 2542 2543 2544 4742 4743 -467 0 4732 4733 4734 -7 0 4732 4733 4734 -467 0 4723 4724 4725 -17 0 4735 4736 4737 -7 0 4735 4736 4737 -467 0 4726 4727 4728 -17 0 4738 4739 4740 -7 0 4738 4739 2518 4153 4154 4155 -456 0 4723 4724 4725 -5 0 4729 4730 4731 -14 0 2634 2515 2516 2517 4742 4743 -7 0 4741 4742 2529 2530 2531 2532 2634 2515 0 2516 2517 -451 0 4726 4727 4728 -5 0 4732 4733 4734 -134 0 4723 4724 4725 -24 0 4723 4724 4725 -325 0 4729 4730 4731 -5 0 4735 4736 4737 -134 0 4726 4727 4728 -16 0 4723 4724 4725 -5 0 4726 4727 4728 -7 0 4723 4724 4725 -12 0 130 -302 0 4732 4733 4734 -5 0 4738 4739 4740 -134 0 4729 4730 4731 -16 0 4726 4727 4728 -5 0 4729 4730 4731 -7 0 4726 4727 4728 -9 0 4723 4724 4725 129 -2 0 4723 4724 4725 -8 0 4723 4724 4725 4723 4724 4725 4723 4724 4725 4723 4724 4725 -4 0 4723 4724 4725 -5 0 4723 4724 4725 -262 0 4735 4736 4737 -5 0 4741 4742 4743 0 2516 2517 -2 0 2634 2515 -127 0 4732 4733 4734 -16 0 4729 4730 4731 -5 0 4732 4733 4734 -7 0 4729 4730 4731 -9 0 4726 4727 4728 129 -2 0 4726 4727 4728 -8 0 4726 4727 4728 4726 4727 4728 4726 4727 4728 4726 4727 4728 -4 0 4726 4727 4728 -5 0 4726 4727 4728 -262 0 4738 4739 4740 -142 0 4735 4736 4737 -16 0 4732 4733 4734 -5 0 4735 4736 4737 -7 0 4732 4733 4734 -9 0 4729 4730 4731 129 -2 0 4729 4730 4731 -8 0 4729 4730 4731 4729 4730 4731 4729 4730 4731 4729 4730 4731 -4 0 4729 4730 4731 -5 0 4729 4730 4731 -262 0 4741 4742 4743 -142 0 4738 4739 4740 -4 0 2533 2534 2539 2540 -8 0 4735 4736 4737 -5 0 4738 4739 4740 2533 2534 2539 2540 -3 0 4735 4736 4737 -9 0 4732 4733 4734 129 -2 0 4732 4733 4734 -8 0 4732 4733 4734 4732 4733 4734 4732 4733 4734 4732 4733 4734 -4 0 4732 4733 4734 -5 0 4732 4733 4734 -407 0 4741 4742 2516 2517 0 2634 2515 2541 2542 2543 2544 -4 0 2518 4153 4154 4155 4738 4739 4740 -2 0 2634 2515 0 4741 4742 4743 2541 2542 2543 2544 -3 0 4738 4739 4740 -9 0 4735 4736 4737 129 -2 0 4735 4736 4737 -8 0 4735 4736 4737 4735 4736 4737 4735 4736 4737 4735 4736 4737 -4 0 4735 4736 4737 -5 0 4735 4736 4737 -420 0 2516 2517 2529 2530 2531 2532 4741 4742 4743 -14 0 2634 2515 4742 4743 -3 0 2516 2517 -4 0 4738 4739 4740 129 -2 0 4738 4739 2533 2534 2539 2540 -5 0 4738 4739 4740 4738 4739 4740 4738 4739 4740 4738 4739 4740 -4 0 4738 4739 4740 2518 4153 4154 4155 0 4738 4739 4740 2533 2534 -269 0 4723 4724 4725 -9 0 4723 4724 4725 -168 0 2516 2517 4741 4742 4743 129 -2 0 4741 4742 2541 2542 2543 2544 2634 2515 -2 0 2516 2517 4742 2634 2515 4742 2516 2517 4742 2634 2515 4742 4743 0 2634 2515 0 4741 4742 4743 2529 2530 2531 2532 0 4741 4742 4743 2541 2542 -252 0 2516 2517 -15 0 4726 4727 4728 -9 0 4726 4727 4728 -485 0 4729 4730 4731 -9 0 4729 4730 4731 -485 0 4732 4733 4734 -9 0 4732 4733 4734 -485 0 4735 4736 4737 -9 0 4735 4736 4737 -476 0 2634 2515 -7 0 4738 4739 4740 -6 0 2533 2534 2539 2540 4739 4740 -485 0 4741 4742 4743 -4 0 2516 2517 2541 2542 2543 2544 4742 4743 0 2634 2515 0 2516 2517 -787 0 4723 4724 4725 -497 0 4726 4727 4728 -66 0 4723 4724 4725 -5 0 4723 4724 4725 -420 0 4729 4730 4731 -66 0 4726 4727 4728 -5 0 4726 4727 4728 -420 0 4732 4733 4734 -8 0 4723 4724 4725 -38 0 4723 4724 4725 -14 0 4729 4730 4731 -5 0 4729 4730 4731 -409 0 4723 4724 4725 -8 0 4735 4736 4737 -8 0 4726 4727 4728 -38 0 4726 4727 4728 -14 0 4732 4733 4734 -5 0 4732 4733 4734 -126 0 3060 -282 0 4726 4727 4728 -8 0 4738 4739 4740 -8 0 4729 4730 4731 -23 0 4723 4724 4725 -12 0 4729 4730 4731 -14 0 4735 4736 4737 -5 0 4735 4736 4737 -126 0 3060 -282 0 4729 4730 4731 -6 0 2634 2515 4741 4742 4743 0 2516 2517 -5 0 4732 4733 4734 -23 0 4726 4727 4728 -12 0 4732 4733 4734 -14 0 4738 4739 4740 -5 0 4738 4739 4740 -126 0 3060 -282 0 4732 4733 4734 -19 0 4735 4736 4737 -23 0 4729 4730 4731 -12 0 4735 4736 4737 -14 0 4741 4742 4743 2634 2515 0 2516 2517 4741 4742 4743 -126 0 3060 -272 0 4723 4724 4725 -7 0 4735 4736 4737 -19 0 4738 4739 4740 -23 0 4732 4733 4734 -9 0 2533 2534 2539 2540 4739 4740 -143 0 4723 4724 4725 -5 0 3060 -3 0 4723 4724 4725 -266 0 4726 4727 4728 -7 0 4738 4739 4740 2533 2534 2539 2540 -15 0 4741 4742 4743 -23 0 4735 4736 4737 -9 0 2541 2542 2543 2544 4742 2516 2517 0 2634 2515 -29 0 4723 4724 4725 -107 0 4726 4727 4728 -5 0 3060 -3 0 4726 4727 4728 -266 0 4729 4730 4731 -4 0 2516 2517 0 4741 4742 4743 2541 2542 2543 2544 -41 0 4738 4739 4740 -48 0 4726 4727 4728 -10 0 4723 4724 4725 -94 0 4729 4730 4731 -5 0 3060 -3 0 4729 4730 4731 -266 0 4732 4733 4734 -51 0 2634 2515 -2 0 4741 4742 4743 -2 0 2516 2517 -44 0 4729 4730 4731 -10 0 4726 4727 4728 -3 0 4723 4724 4725 -88 0 4732 4733 4734 -5 0 3060 -3 0 4732 4733 4734 -211 0 4723 4724 4725 -39 0 4723 4724 4725 -10 0 4735 4736 4737 -106 0 4732 4733 4734 -10 0 4729 4730 4731 -3 0 4726 4727 4728 -88 0 4735 4736 4737 -5 0 3060 -3 0 4735 4736 4737 -211 0 4726 4727 4728 -6 0 4723 4724 4725 -18 0 4723 4724 4725 -9 0 4726 4727 4728 -10 0 4738 4739 4740 -106 0 4735 4736 4737 -10 0 4732 4733 4734 -3 0 4729 4730 4731 -4 0 4723 4724 4725 -81 0 4738 4739 2533 2534 2539 2540 -2 0 3060 -3 0 4738 4739 4740 2518 4153 4154 4155 -207 0 4729 4730 4731 -6 0 4726 4727 4728 -18 0 4726 4727 4728 -9 0 4729 4730 4731 -5 0 2516 2517 2634 2515 0 4741 4742 4743 -106 0 4738 4739 4740 -10 0 4735 4736 4737 -3 0 4732 4733 4734 -4 0 4726 4727 4728 -6 0 4723 4724 4725 -70 0 2634 2515 4741 4742 2541 2542 2543 2544 -2 0 3060 -3 0 4741 4742 4743 2529 2530 2531 2532 2634 2515 -2 0 2516 2517 -2 0 2634 2515 -197 0 4732 4733 4734 -6 0 4729 4730 4731 -18 0 4729 4730 4731 -9 0 4732 4733 4734 -116 0 2516 2517 0 4741 4742 4743 2634 2515 -5 0 2518 4153 4154 4155 4739 4740 -3 0 4735 4736 4737 -4 0 4729 4730 4731 -6 0 4726 4727 4728 -80 0 3060 -217 0 4735 4736 4737 -6 0 4732 4733 4734 -18 0 4732 4733 4734 -9 0 4735 4736 4737 -127 0 2516 2517 2529 2530 2531 2532 4742 4743 -3 0 4738 4739 4740 -4 0 4732 4733 4734 -6 0 4729 4730 4731 -13 0 4723 4724 4725 -64 0 3060 -217 0 4738 4739 4740 -6 0 4735 4736 4737 -18 0 4735 4736 4737 -9 0 4738 4739 4740 -136 0 2634 2515 4741 4742 2516 2517 -3 0 4735 4736 4737 -6 0 4732 4733 4734 -13 0 4726 4727 4728 -64 0 3060 -217 0 4741 4742 4743 0 2634 2515 -3 0 4738 4739 4740 -18 0 4738 4739 4740 -3 0 2518 4153 4154 4155 -2 0 4741 4742 4743 2516 2517 -143 0 4738 4739 4740 2533 2534 2539 2540 -2 0 4735 4736 4737 -13 0 4729 4730 4731 -8 0 4723 4724 4725 -53 0 3060 -226 0 4741 4742 4743 2516 2517 -16 0 4741 4742 2516 2517 2634 2515 2529 2530 2531 2532 -149 0 2516 2517 4742 4743 2541 2542 2543 2544 -2 0 4738 4739 4740 -13 0 4732 4733 4734 -8 0 4726 4727 4728 -5 0 4723 4724 4725 -38 0 4723 4724 4725 -4 0 3060 -3 0 4723 4724 4725 -409 0 2516 2517 4742 4743 0 2634 2515 -10 0 4735 4736 4737 -8 0 4729 4730 4731 -5 0 4726 4727 4728 -38 0 4726 4727 4728 -4 0 3060 -3 0 4726 4727 4728 -424 0 2634 2515 4738 4739 4740 -8 0 4732 4733 4734 -5 0 4729 4730 4731 -11 0 4723 4724 4725 -24 0 4729 4730 4731 -4 0 3060 -3 0 4729 4730 4731 -426 0 4741 4742 4743 -8 0 4735 4736 4737 -5 0 4732 4733 4734 -11 0 4726 4727 4728 -24 0 4732 4733 4734 -4 0 3060 -3 0 4732 4733 4734 -434 0 2516 2517 0 4738 4739 4740 -5 0 4735 4736 4737 -11 0 4729 4730 4731 -24 0 4735 4736 4737 -4 0 3060 -3 0 4735 4736 4737 -437 0 4741 4742 4743 -5 0 4738 4739 4740 -11 0 4732 4733 4734 -24 0 4738 4739 4740 -4 0 3060 -3 0 4738 4739 4740 -445 0 4741 4742 4743 -11 0 4735 4736 4737 0 2518 4153 4154 4155 -18 0 2634 2515 4742 4743 -4 0 3060 -3 0 4741 4742 2516 2517 2634 2515 -445 0 2634 2515 -9 0 4738 4739 4740 0 2529 2530 2531 2532 2634 2515 -11 0 2516 2517 -11 0 3060 -463 0 2634 2515 4741 4742 2516 2517 -30 0 3061 -3216 0)
    )
    (tilemap
      (solid #f)
      (z-pos 100)
      (width 500)
      (height 65)
      (tiles -6316 0 3793 3794 3795 -497 0 3797 3798 3799 -494 0 3820 -975 0 3820 -20 0 3804 -148 0 130 -327 0 3804 -15 0 3820 -14 0 3828 -140 0 129 -329 0 3824 -10 0 3800 -5 0 3824 -152 0 129 -311 0 3820 -5 0 3824 -31 0 3824 -5 0 3820 -143 0 129 -499 0 129 -351 0 3828 -147 0 129 -499 0 129 -451 0 3824 -47 0 129 -351 0 3793 3794 3795 -497 0 3797 3798 3799 -100 0 3820 -11 0 3820 -7 0 3804 3800 -11 0 3820 -30 0 3824 -429 0 3800 -46 0 3824 -9 0 3824 -3 0 3800 -20 0 3824 -318 0 3828 -5 0 3824 -104 0 3828 -18 0 3820 -18 0 3793 3794 3795 -11 0 3804 0 3820 -337 0 3828 -118 0 3824 -11 0 3828 -14 0 3797 3798 3799 -26 0 3824 -420 0 3820 -7 0 3793 3794 3795 -32 0 3824 -11 0 3828 0 3820 -12 0 3824 -2 0 3793 3794 3795 -7 0 3800 -4 0 3824 -419 0 3797 3798 3799 -9 0 3828 -52 0 3797 3798 3799 -14 0 3824 -272 0 3820 -16 0 3828 -26 0 3800 -107 0 3824 -13 0 3828 -3 0 3824 -26 0 3824 -307 0 3793 3794 3795 -2 0 3824 -3 0 3804 -25 0 3828 -464 0 3797 3798 3799 -10 0 3828 -122 0 3824 -11 0 3828 -7 0 3828 -55 0 3824 3828 -282 0 3828 -7 0 3828 -5 0 3820 -29 0 3828 -129 0 3828 -14 0 3824 -455 0 3828 -38 0 3824 -18 0 3824 -334 0 3824 -172 0 3824 -331 0 3828 -623 0 3828 -143 0 3804 -225 0 3828 -117 0 3828 -486 0 3828 -161 0 3824 -235 0 3824 -265 0 3793 3794 3795 -4 0 3820 -62 0 3820 -5 0 3800 -163 0 3828 -259 0 3797 3798 3799 -9 0 3824 -37 0 3820 -438 0 3800 -64 0 3804 -182 0 3828 -257 0 3820 -41 0 3800 -20 0 3820 -10 0 3824 -160 0 3828 -343 0 3804 -123 0 3828 -34 0 3828 -282 0 3820 -23 0 3824 -21 0 3824 -470 0 3820 -49 0 3824 -134 0 3820 -3 0 3793 3794 3795 -252 0 3824 0 3820 -44 0 3804 -55 0 3820 -9 0 3793 3794 3795 -129 0 3797 3798 3799 -8 0 3828 -3 0 3828 -300 0 3793 3794 3795 -7 0 3824 -41 0 3797 3798 3799 -3 0 3820 -372 0 3804 -68 0 3797 3798 3799 -63 0 3820 -124 0 3824 -199 0 3820 -37 0 3824 -118 0 3824 -28 0 3820 -103 0 3828 -218 0 3804 -18 0 3793 3794 3795 -3 0 3820 -134 0 3824 -13 0 3804 -112 0 3800 -200 0 3793 3794 3795 -12 0 3820 -11 0 3824 -3 0 3797 3798 3799 -160 0 3820 -4 0 3800 -300 0 3797 3798 3799 -18 0 3800 -154 0 3828 -506 0 3824 -27 0 3793 3794 3795 -80 0 3824 -372 0 3828 -25 0 3828 -17 0 3797 3798 3799 -509 0 3804 -8 0 3824 -52 0 3828 -395 0 3828 -7 0 3828 -22 0 3824 -20 0 3820 -39 0 3820 -15 0 3804 -379 0 3828 -75 0 3828 -5 0 3804 -7 0 3828 -11 0 3824 -13 0 3820 -413 0 3828 -11 0 3828 -36 0 3824 -14 0 3793 3794 3795 -480 0 3800 -8 0 3820 -7 0 3797 3798 3799 -910 0 3828 -319 0)
    )
    (tilemap
      (solid #t)
      (z-pos 0)
      (width 500)
      (height 65)
      (tiles -2319 0 2817 -1969 0 2817 -9 0 2817 -1012 0 4665 -7 4666 4667 -490 0 4665 4677 -7 4669 4670 -5 0 4640 4641 4642 -5 0 4640 4641 4642 -5 0 4640 4641 4642 -424 0 2817 -40 0 4665 4677 -8 4669 4670 -488 0 4665 4677 -9 4669 4670 -440 0 2817 -21 0 4665 -7 4666 4667 -5 0 4665 -11 4666 4677 -10 4669 4670 -461 0 4665 4677 -7 4669 4670 -5 0 4668 -22 4669 4670 -85 0 2817 -26 0 2817 -347 0 4665 4677 -8 4669 4670 -5 0 4668 -22 4669 4670 -104 0 2817 -17 0 2817 -336 0 4665 4677 -9 4669 4670 -5 0 4668 -22 4669 4670 -134 0 2817 -5 0 2817 -10 0 2817 -2 0 2817 -2 0 2817 -2 0 2817 -6 0 2817 -7 0 2817 -271 0 4665 -11 4666 4677 -10 4669 4670 -5 0 4668 -22 4669 4670 -447 0 4668 -22 4669 4670 -5 0 4668 -22 4669 4670 -439 0 4665 4666 4667 -5 0 4671 -22 4672 4673 -5 0 4671 -8 4672 4675 -13 4669 4670 -439 0 4671 4672 4673 -43 0 4668 -13 4669 4670 -83 0 4665 -10 4666 4667 -12 0 4665 -10 4666 4667 -366 0 4668 -13 4669 4670 -83 0 4668 -10 4669 4676 -12 4666 4677 -10 4669 4676 -10 4666 4667 -319 0 2817 -11 0 2817 -23 0 4668 -13 4669 4670 -83 0 4668 -45 4669 4676 -49 4666 -252 0 4665 4666 4667 -51 0 4668 -13 4669 4670 -83 0 4668 -95 4669 -252 0 4671 4672 4673 -51 0 4668 -13 4669 4670 -83 0 4668 -95 4669 -306 0 4668 -13 4669 4670 -83 0 4668 -95 4669 -306 0 4668 -13 4669 4670 -83 0 4668 -95 4669 -260 0 4665 4666 4667 -43 0 4668 -13 4669 4670 -83 0 4668 -95 4669 -260 0 4671 4672 4673 -5 0 4665 -22 4666 4667 -14 0 4668 -13 4669 4670 -83 0 4668 -95 4669 -268 0 4668 -22 4669 4670 -14 0 4668 -13 4669 4670 -83 0 4668 -95 4669 -78 0 2817 -189 0 4668 -22 4669 4670 -14 0 4668 -13 4669 4670 -83 0 4668 -95 4669 -147 0 2817 -7 0 2817 -112 0 4668 -22 4669 4670 -6 0 4640 4641 4642 -5 0 4668 -13 4669 4670 -83 0 4668 -95 4669 -268 0 4668 -22 4669 4670 -14 0 4668 -13 4669 4670 -83 0 4668 -95 4669 -89 0 2817 -40 0 2817 -137 0 4668 -22 4669 4670 -14 0 4668 -13 4669 4670 -83 0 4668 -95 4669 -67 0 2817 -200 0 4668 -2 4669 4674 -19 4672 4673 -14 0 4668 -13 4669 4670 -83 0 4668 -95 4669 -115 0 2817 -152 0 4668 -2 4669 4670 -22 0 4640 4641 4642 -9 0 4668 -13 4669 4670 -83 0 4668 -95 4669 -74 0 4665 -11 4666 4667 -181 0 4668 -2 4669 4670 -34 0 4668 -13 4669 4670 -83 0 4668 -95 4669 -74 0 4668 -11 4669 4676 4667 -57 0 4665 -11 4666 4667 -110 0 4668 -2 4669 4670 -34 0 4668 -13 4669 4670 -83 0 4668 -95 4669 -57 0 2817 -16 0 4668 -12 4669 4676 4667 -56 0 4668 -11 4669 4670 -110 0 4668 -2 4669 4670 -4 0 2817 -11 0 2817 -9 0 4640 4641 4642 -5 0 4668 -13 4669 4670 -83 0 4668 -95 4669 -74 0 4668 -13 4669 4676 4666 4667 -35 0 4665 -12 4666 4667 -5 0 4668 -11 4669 4670 -8 0 2817 -101 0 4668 -2 4669 4670 -34 0 4668 -13 4669 4670 -83 0 4668 -95 4669 -62 0 4665 -11 4666 4677 -15 4669 4676 4666 4667 -33 0 4668 -12 4669 4670 -5 0 4668 -11 4669 4670 -21 0 2817 -88 0 4668 -2 4669 4670 -34 0 4668 -13 4669 4670 -83 0 4668 -95 4669 -62 0 4668 -29 4669 4676 4667 -14 0 4665 -11 4666 4667 -5 0 4668 -12 4669 4670 -5 0 4668 -11 4669 4670 -27 0 2817 -82 0 4668 -2 4669 4670 83 102 83 -27 0 4640 4641 4642 0 4668 -13 4669 4670 -83 0 4668 -95 4669 -2 0 2817 -41 0 2817 -17 0 4668 -30 4669 4676 4666 4667 -12 0 4668 -11 4669 4670 -5 0 4668 -12 4669 4676 -5 4666 4677 -11 4669 4670 -110 0 4668 -2 4669 4670 -34 0 4668 -13 4669 4670 -83 0 4668 -95 4669 -11 0 2817 -20 0 2817 -29 0 4668 -32 4669 4676 4667 -11 0 4668 -11 4669 4670 -5 0 4668 -30 4669 4676 4667 -33 0 2817 -75 0 4668 -2 4669 4670 -34 0 4668 -13 4669 4670 -83 0 4668 -95 4669 -50 0 4665 -11 4666 4677 -33 4669 4676 4666 4667 -9 0 4668 -11 4669 4670 -5 0 4668 -31 4669 4676 4667 -41 0 2817 -66 0 4668 -2 4669 4676 -8 4666 4667 -5 0 4665 -19 4666 4677 -13 4669 4670 -83 0 4668 -95 4669 -50 0 4668 -47 4669 4676 -9 4666 4677 -11 4669 4676 -5 4666 4677 -32 4669 4676 -11 4666 4667 -96 0 4668 -11 4669 4670 -5 0 4668 -33 4669 4670 -83 0 4668 -95 4669 -50 0 4668 -120 4669 4676 -8 4666 4667 -36 0 2817 -50 0 4671 -11 4672 4673 -5 0 4671 -7 4672 4675 -25 4669 4670 -83 0 4668 -95 4669 -50 0 4668 -129 4669 4676 -7 4666 4667 -105 0 4668 -25 4669 4670 -83 0 4668 -95 4669 -8 4666 4667 -33 0 4665 -7 4666 4677 -137 4669 4676 4667 -38 0 2817 -65 0 4668 -25 4669 4670 -83 0 4668 -103 4669 4676 -6 4666 4667 -14 0 4665 -11 4666 4677 -146 4669 4676 -8 4666 4667 -37 0 2817 -40 0 2817 -16 0 4668 -25 4669 4670 -83 0 4668 -110 4669 4676 -14 4666 4677 -167 4669 4676 -8 4666 4667 -86 0 4668 -25 4669 4670 -83 0 4668 -302 4669 4670 -5 0 4665 4666 4667 -34 0 2817 -43 0 4668 -25 4669 4670 -83 0 4668 -302 4669 4670 -5 0 4668 4669 4676 -2 4666 4667 -75 0 4668 -25 4669 4670 -83 0 4668 -302 4669 4670 -5 0 4668 -4 4669 4670 -5 0 4665 4666 4667 -67 0 4668 -25 4669 4670 -83 0 4668 -302 4669 4670 -5 0 4668 -4 4669 4670 -5 0 4668 4669 4676 -2 4666 4667 -64 0 4668 -25 4669 4670 -83 0 4668 -302 4669 4670 -5 0 4668 -4 4669 4670 -5 0 4668 -4 4669 4670 -5 0 4665 4666 4667 -36 0 4665 -5 4666 4667 -5 0 4665 -7 4666 4677 -25 4669 4670 -83 0 4668 -302 4669 4670 -5 0 4668 -4 4669 4670 -5 0 4668 -4 4669 4670 -5 0 4668 4669 4676 -2 4666 4667 -12 0 4665 -5 4666 4667 -7 0 4665 -6 4666 4677 -5 4669 4670 -5 0 4668 -33 4669 4670 -83 0 4668 -302 4669 4670 -5 0 4668 -4 4669 4670 -5 0 4668 -4 4669 4670 -5 0 4668 -4 4669 4670 -5 0 4665 -6 4666 4677 -5 4669 4676 -7 4666 4677 -12 4669 4670 -5 0 4668 -33 4669 4670 -83 0 4668 -302 4669 4670 -5 0 4668 -4 4669 4670 -5 0 4668 -4 4669 4670 -5 0 4668 -4 4669 4670 -5 0 4668 -33 4669 4670 -5 0 4668 -33 4669 4670 -83 0 4668 -302 4669 4670 -5 0 4668 -4 4669 4670 -5 0 4668 -4 4669 4670 -5 0 4668 -4 4669 4670 -5 0 4668 -33 4669 4670 -5 0 4668 -33 4669 4670 -83 0 4668 -302 4669 4670 -5 0 4668 -4 4669 4670 -5 0 4668 -4 4669 4670 -5 0 4668 -4 4669 4670 -5 0 4668 -33 4669 4670 -5 0 4668 -33 4669 4670 -83 0 4668 -302 4669 4670 -5 0 4668 -4 4669 4670 -5 0 4668 -4 4669 4670 -5 0 4668 -4 4669 4670 -5 0 4668 -33 4669 4670 -5 0 4668 -33 4669 4670 -83 0 4668 -302 4669 4670 -5 0 4668 -4 4669 4670 -5 0 4668 -4 4669 4670 -5 0 4668 -4 4669 4670 -5 0 4668 -33 4669 4670 -5 0 4668 -33 4669 4670 -83 0 4668 -302 4669 4670 -5 0 4668 -4 4669 4670 -5 0 4668 -4 4669 4670 -5 0 4668 -4 4669 4670 -5 0 4668 -33 4669 4670 -5 0 4668 -33 4669 4670 -83 0 4668 -95 4669)
    )
    (tilemap
      (solid #t)
      (tint 0.1529412 0.8352941 0)
      (z-pos -1)
      (width 500)
      (height 65)
      (tiles -11820 0 2136 2137 2138 2139 2136 2137 2138 2139 2136 2137 2138 2139 2136 2137 2138 2139 2136 2137 2138 2139 2136 2137 2138 2139 2136 2137 2138 2139 2136 2137 2138 2139 2136 2137 2138 2139 2136 2137 2138 2139 2136 2137 2138 2139 2136 2137 2138 2139 2136 2137 2138 2139 2136 2137 2138 2139 2136 2137 2138 2139 2136 2137 2138 2139 2136 2137 2138 2139 2136 2137 2138 2139 2136 2137 2138 2139 2136 2137 2138 2139 2136 2137 2138 2139 2136 -415 0 -85 4004 -415 0 -85 4004 -415 0 -85 4004 -415 0 -85 4004 -415 0 -85 4004 -415 0 -85 4004 -415 0 -85 4004 -415 0 -85 4004 -415 0 -85 4004 -415 0 -85 4004 -415 0 -85 4004 -415 0 -85 4004 -415 0 -85 4004 -415 0 -85 4004 -415 0 -85 4004 -415 0 -85 4004 -415 0 -85 4004 -415 0 -85 4004 -234 0 2136 2137 2138 2139 2136 2137 2138 -174 0 -85 4004 -234 0 -7 4004 -174 0 -85 4004 -215 0 2136 2137 2138 2139 2136 2137 2138 -193 0 -85 4004 -215 0 -7 4004 -193 0 -85 4004 -215 0 -7 4004 -193 0 -85 4004 -415 0 -85 4004 -415 0 -85 4004 -415 0 -85 4004 -415 0 -85 4004 -415 0 -85 4004 -415 0 -85 4004 -415 0 -85 4004 -302 0 2136 2137 2138 2139 2136 2137 2138 -106 0 -85 4004 -302 0 -7 4004 -106 0 -85 4004 -302 0 -7 4004 -4 0 2136 2137 2138 2139 2136 2137 2138 -95 0 -85 4004 -302 0 -7 4004 -4 0 -7 4004 -95 0 -85 4004 -302 0 -7 4004 -4 0 -7 4004 -4 0 2136 2137 2138 2139 2136 2137 2138 -84 0 -85 4004 -302 0 -7 4004 -4 0 -7 4004 -4 0 -7 4004 -84 0 -85 4004 -302 0 -7 4004 -4 0 -7 4004 -4 0 -7 4004 -4 0 2136 2137 2138 2139 2136 2137 2138 -33 0 2136 2137 2138 2139 2136 2137 2138 -33 0 -85 4004 -302 0 -7 4004 -4 0 -7 4004 -4 0 -7 4004 -4 0 -7 4004 -33 0 -7 4004 -33 0 -85 4004 -302 0 -7 4004 -4 0 -7 4004 -4 0 -7 4004 -4 0 -7 4004 -33 0 -7 4004 -33 0 -85 4004 -302 0 -7 4004 -4 0 -7 4004 -4 0 -7 4004 -4 0 -7 4004 -33 0 -7 4004 -33 0 -85 4004 -302 0 -7 4004 -4 0 -7 4004 -4 0 -7 4004 -4 0 -7 4004 -33 0 -7 4004 -33 0 -85 4004 -95 0)
    )
    (tilemap
      (solid #t)
      (z-pos 1)
      (width 500)
      (height 65)
      (tiles -3814 0 77 -3 83 77 -3 0 -3 44 -5 0 -3 44 -5 0 -3 44 -5 0 -3 44 -1437 0 -3 44 -13 0 -2 44 -47 0 -2 44 -432 0 44 -3 0 44 -11 0 44 -2 0 44 -1966 0 77 83 -2 77 2948 77 -1154 0 44 -4 0 44 -471 0 77 -2 83 77 -18 0 44 0 44 -2 0 44 0 44 -482 0 -4 83 -977 0 -2 44 -514 0 44 0 44 0 -2 44 0 44 0 44 -1843 0 -3 44 0 77 83 77 -2 0 83 -3 0 77 83 77 0 -3 44 -3287 0 -2 44 -497 0 44 -2 0 44 -70 0 -3 44 -496 0 44 -3 0 44 -478 0 -2 44 -431 0 -2 44 -64 0 44 -2 0 44 -429 0 44 -2 0 44 -45 0 -3 44 -496 0 44 -3 0 44 -936 0 -2 44 -497 0 44 -2 0 44 -112 0 -2 44 -119 0 -3 44 -3 0 -3 44 -369 0 44 -2 0 44 -2038 0 -2 44 -497 0 44 -2 0 44 -500 0 44 -7 0 -2 44 -295 0 44 0 44 0 44 -2 0 44 0 44 0 44 -190 0 44 -2 0 44 -500 0 44 -7 0 -2 44 -497 0 44 -2 0 44 -48 0 -3 44 -449 0 44 -7 0 -2 44 -37 0 44 -3 0 44 -5 0 -3 83 -447 0 44 -2 0 44 -500 0 44 -4754 0)
    )
    (tilemap
      (solid #t)
      (z-pos -99)
      (width 500)
      (height 65)
      (tiles -5313 0 4762 4763 4764 4765 -1967 0 4762 4763 4764 4763 4764 4765 -13 0 4762 4763 4764 4765 -1965 0 4762 4763 4764 4765 -1632 0 4762 4763 4764 4763 4764 4765 -21 0 4762 4763 4764 4765 -478 0 4762 4763 4764 4763 4764 4765 -18 0 4762 4763 4764 4763 4764 4765 -506 0 4762 4763 4764 4765 -7 0 4762 4763 4764 4763 4764 4763 4764 4763 4764 4763 4764 -2 4763 4764 4763 4764 -2 4763 4764 4763 4764 4763 4764 4765 -3 0 4762 4763 4764 4765 -2776 0 4762 4763 4764 4763 4764 4763 4764 4763 4764 4765 -3794 0 4762 -2 4763 4764 4763 4764 4763 4764 4763 4764 4765 -560 0 4762 -2 4763 4764 4763 4764 4763 4764 4763 4764 4765 -917 0 4628 -52 0 4762 4763 4764 4763 4764 4763 4764 4763 4764 4763 4764 4765 -424 0 4762 -2 4763 4764 4763 4764 4763 4764 4763 4765 4628 4654 -534 0 4762 -2 4763 4764 4763 4764 4763 4764 4763 4764 4765 -942 0 4628 -488 0 4762 -2 4763 4764 4763 4764 4763 4765 -2 0 4628 4654 -33 0 -13 4629 -163 0 4762 4763 4764 4763 4764 4765 -16 0 4762 4763 4764 4763 4764 4763 4764 4763 4764 4765 -292 0 -13 4633 -52 0 4762 4763 4764 4763 4764 4763 4764 4763 4764 4765 -502 0 4762 -4 4763 4764 4765 -370 0 4628 -131 0 4762 -2 4763 4764 4765 -317 0 4762 4763 4764 4765 -41 0 4628 4654 -486 0 4762 4763 4764 4765 -474 0 -16 4629 -170 0 4762 -2 4763 4764 4765 -2569 0 4762 4763 4764 4765 -8 0 4762 4763 4764 4765 -463 0 4762 -2 4763 4764 4765 -500 0 -9 4629 -3232 0)
    )
  )
)
