(supertux-level
  (version 3)
  (name (_ "The Robot Tux"))
  (author "Sophie Ball")
  (license "CC-BY-SA 4.0 International")
  (allow-item-pocket "inherit")
  (icon "")
  (icon-locked "")
  (statistics
    (enable-coins #f)
    (enable-badguys #f)
    (enable-secrets #f)
  )
  (sector
    (name "main")
    (init-script "rtux.stop_moving();
time.stop();")
    (ambient-light
      (color 1 0.9 1)
    )
    (background
      (scroll-offset-y 350)
      (color 1 1 1)
      (alignment "bottom")
      (speed 0.2)
      (image "/images/background/desert/arcticmountains.png")
    )
    (background
      (color 1 1 1)
      (speed 0)
      (image "/images/background/antarctic/SnowMountainsSky.png")
      (z-pos -301)
    )
    (background
      (color 1 0.8901961 0.5411765 0.3)
      (speed 0.5)
      (image "/images/background/misc/fog.png")
      (z-pos 300)
    )
    (camera
      (name "Camera")
      (mode "normal")
    )
    (gradient
      (top_color 1 0.6627451 0.2392157)
      (bottom_color 0.04313726 0 0.9490196)
      (z-pos -302)
    )
    (gradient
      (top_color 1 0.6313726 0.9372549 0.2)
      (bottom_color 0.5960785 0 0.345098 0.1)
      (z-pos 301)
    )
    (hurting_platform
      (z-pos 50)
      (handle
        (scale_x 0)
        (scale_y 0)
        (offset_x 0)
        (offset_y 0)
      )
      (running #f)
      (name "rtux")
      (path-ref "gen1740168051124477752370624")
      (sprite "/images/creatures/robot_tux/robot_tux.sprite")
    )
    (leveltime
      (name "time")
      (time 36)
    )
    (music
      (file "/music/misc/battle_theme.music")
    )
    (path
      (name "gen1740168051124477752370624")
      (path
        (mode "oneshot")
        (adapt_speed #f)
        (node
          (x 384)
          (y 512)
        )
        (node
          (x 480)
          (y 544)
        )
        (node
          (x 576)
          (y 640)
        )
        (node
          (x 672)
          (y 736)
        )
        (node
          (x 704)
          (y 768)
        )
        (node
          (x 960)
          (y 672)
        )
        (node
          (x 1216)
          (y 768)
        )
        (node
          (x 1376)
          (y 704)
        )
        (node
          (x 1536)
          (y 736)
        )
        (node
          (x 1696)
          (y 704)
        )
        (node
          (x 2208)
          (y 480)
        )
        (node
          (x 2912)
          (y 480)
        )
        (node
          (x 3104)
          (y 736)
        )
        (node
          (x 3136)
          (y 768)
        )
        (node
          (x 3296)
          (y 768)
        )
        (node
          (x 3392)
          (y 736)
        )
        (node
          (x 3968)
          (y 576)
        )
        (node
          (x 5376)
          (y 416)
        )
        (node
          (x 6080)
          (y 288)
        )
        (node
          (x 6756.25)
          (y 63.75)
        )
        (node
          (x 7136)
          (y 352)
        )
        (node
          (x 7936)
          (y 352)
        )
        (node
          (x 7936)
          (y 96)
        )
        (node
          (x 8064)
          (y 0)
        )
        (node
          (x 8288)
          (y 128)
        )
        (node
          (x 8384)
          (y 256)
        )
        (node
          (x 8480)
          (y 320)
        )
        (node
          (x 8512)
          (y 352)
        )
        (node
          (x 8576.251)
          (y 416.25)
        )
        (node
          (x 8615.001)
          (y 450)
        )
        (node
          (x 9344)
          (y 320)
        )
        (node
          (x 9504)
          (y 448)
        )
        (node
          (x 9670.001)
          (y 572.5)
        )
        (node
          (x 9696)
          (y 640)
        )
        (node
          (x 9763.751)
          (y 672.5)
        )
        (node
          (x 9856)
          (y 896)
        )
        (node
          (x 9888.751)
          (y 956.2501)
        )
        (node
          (x 9952)
          (y 992)
        )
        (node
          (x 10496)
          (y 992)
        )
        (node
          (x 10880)
          (y 960)
        )
        (node
          (x 11072)
          (y 928)
        )
        (node
          (x 11232)
          (y 896)
        )
        (node
          (x 11584)
          (y 896)
        )
        (node
          (x 12096)
          (y 928)
        )
        (node
          (x 12704)
          (y 1952)
        )
      )
    )
    (scripttrigger
      (oneshot #t)
      (script "Tux.deactivate();
wait(0.5);
Text.set_text(\"3\");
Text.set_font(\"normal\");
Text.fade_in(1);
wait(1);
Text.set_text(\"2\");
wait(1);
Text.set_text(\"1\");

wait(1);
Tux.activate();
rtux.start_moving();
rtux.set_action(\"fast-right\");
Text.set_text(\"RACE!\");
time.start();
play_music(\"music/boss/robot_tux.music\");
wait(1);
Text.fade_out(1);
wait(36);
rtux.stop_moving();
a.fade(1, 0);")
      (button #f)
      (width 32)
      (height 32)
      (x 512)
      (y 704)
    )
    (sequencetrigger
      (sequence "fireworks")
      (width 32)
      (height 128)
      (x 12640)
      (y 1920)
    )
    (spawnpoint
      (name "main")
      (x 64)
      (y 672)
    )
    (tilemap
      (solid #f)
      (z-pos -100)
      (width 400)
      (height 65)
      (tiles -6402 0 4723 4724 4725 -7 0 4723 4724 4725 -387 0 4726 4727 4728 -7 0 4726 4727 4728 -387 0 4729 4730 4731 -7 0 4729 4730 4731 -387 0 4732 4733 4734 -7 0 4732 4733 4734 -387 0 4735 4736 4737 -7 0 4735 4736 4737 -387 0 4738 4739 4740 -7 0 4738 4739 4740 -385 0 4762 4765 4741 4742 0 4762 -2 4763 4764 4765 2516 2517 4741 4742 4743 2634 2515 -17183 0)
    )
    (tilemap
      (solid #f)
      (z-pos 100)
      (width 400)
      (height 65)
      (tiles -26000 0)
    )
    (tilemap
      (solid #t)
      (z-pos 0)
      (width 400)
      (height 65)
      (tiles -8800 0 -16 4666 4667 -383 0 -16 4669 4670 -383 0 -16 4669 4670 -383 0 -16 4669 4670 -383 0 -16 4669 4670 -383 0 -16 4669 4670 -383 0 -16 4669 4670 -383 0 -16 4669 4670 -383 0 -16 4669 4670 -383 0 -16 4669 4670 -383 0 -16 4669 4670 -383 0 -16 4669 4670 -383 0 -16 4669 4670 -383 0 -16 4669 4670 -383 0 -16 4669 4670 -383 0 -16 4669 4670 -383 0 -16 4669 4670 -383 0 -16 4669 4670 -383 0 -16 4669 4670 -383 0 -16 4669 4670 -383 0 -16 4669 4670 -383 0 -16 4669 4670 -383 0 -16 4669 4670 -383 0 -16 4669 4670 -383 0 -16 4669 4670 -383 0 -16 4669 4670 -383 0 -16 4669 4670 -383 0 -16 4669 4670 -383 0 -16 4669 4670 -383 0 -16 4669 4670 -383 0 -16 4669 4670 -383 0 -16 4669 4670 -383 0 -16 4669 4670 -383 0 -16 4669 4670 -383 0 -16 4669 4670 -383 0 -16 4669 4670 -383 0 -16 4669 4670 -383 0 -16 4669 4670 -383 0 -16 4669 4670 -383 0 -16 4669 4670 -383 0 -16 4669 4670 -383 0 -16 4669 4670 -383 0 -16 4669 4670 -383 0)
    )
    (tilemap
      (solid #t)
      (z-pos -1)
      (width 400)
      (height 65)
      (tiles -3025 0 3199 3200 -6 0 3199 3200 -6 0 3199 3200 -380 0 3183 3184 3183 3184 3183 3184 3183 3184 3183 3184 3183 3184 3183 3184 3183 3184 3183 3184 3183 3184 3183 3184 3183 3184 3194 -4 0 3193 3183 3184 3183 3184 3188 -398 0 3170 3193 3188 -397 0 3189 0 3193 3188 -396 0 3190 -2 0 3193 3188 -357 0 3187 3188 -36 0 3189 -3 0 3193 3188 -355 0 3187 3194 3193 3188 -35 0 3190 -4 0 3193 3188 -351 0 3187 3183 3184 3194 -2 0 3193 3188 -34 0 3189 -5 0 3193 3188 -349 0 3187 3194 -6 0 3193 3188 -2 0 3199 -20 3197 3200 -9 0 3190 -6 0 3193 3188 -345 0 3187 3183 3184 3194 -8 0 3193 3183 3184 3183 3184 3183 3184 3183 3184 3183 3184 3183 3184 3183 3184 3183 3184 3183 3184 3183 3184 3183 3184 3183 3184 3183 3184 3183 3184 3183 3184 3183 3184 3183 3184 -7 0 3193 3188 -343 0 3187 3194 -54 0 3193 3188 -319 0 3193 3183 3184 3194 -5 0 3170 -5 0 3170 -5 0 3183 3184 3194 -56 0 3193 3188 -399 0 3193 3188 -202 0 3199 -2 3197 3200 -100 0 3193 3183 3184 3194 -89 0 3193 3188 -198 0 3187 3183 3184 3183 3184 3183 3184 3183 3184 3183 3184 3183 3184 3183 3184 3183 3184 3183 3184 3183 3184 3183 3184 3188 -177 0 3193 3188 -196 0 3187 3194 -22 0 3193 3188 -71 0 3193 3183 3184 3194 -102 0 3193 3183 3184 3183 3184 3183 3184 3183 3184 3183 3184 3183 3184 3183 3184 3183 3184 3183 3184 3183 3184 3188 -123 0 3183 3184 3188 -42 0 3187 3183 3184 3183 3184 3183 3184 3194 -24 0 3193 3188 -197 0 3193 3188 -124 0 3193 3188 -40 0 3187 3194 -32 0 3193 3188 -58 0 3193 3183 3184 3194 -135 0 3193 3188 -124 0 3193 3188 -8 0 3187 3188 -2 0 3187 3188 -8 0 3187 3188 -8 0 3187 3183 3184 3183 3184 3183 3184 3194 -34 0 3193 3188 -12 0 3199 -2 3197 3200 -2 0 3187 3183 3184 3183 3184 3183 3184 3183 3184 3194 -7 0 3193 3183 3184 3194 -7 0 3193 3183 3184 3194 -147 0 3193 3188 -124 0 3193 3188 -6 0 3187 3194 3193 3188 3187 3194 3193 3188 -6 0 3187 3194 3193 3188 -6 0 3187 3194 -42 0 3193 3188 -8 0 3187 3183 3184 3183 3184 3183 3184 3183 3184 3194 -179 0 3193 3188 -124 0 3193 3183 3184 3183 3184 3183 3184 3194 -2 0 3193 3194 -2 0 3193 3183 3184 3183 3184 3183 3184 3194 -2 0 3193 3183 3184 3183 3184 3183 3184 3194 -44 0 3193 3183 3184 3183 3184 3183 3184 3183 3184 3194 -189 0 3193 3188 -399 0 3193 3188 -399 0 3193 3188 -399 0 3193 3188 -399 0 3193 3188 -399 0 3193 3188 -399 0 3193 3188 -399 0 3193 3188 -399 0 3193 3188 -399 0 3193 3183 3184 3183 3184 3183 3184 3183 3184 3183 3184 3183 3184 3183 3184 3183 3184 3183 3184 3183 3184 3183 3184 3183 3184 3183 3184 3183 3184 3183 3184 3188 -399 0 3193 3188 -399 0 3193 3188 -399 0 3193 3188 -399 0 3193 3188 -399 0 3193 3188 -399 0 3193 3188 -399 0 3193 3188 -399 0 3193 3188 -399 0 3193 3188 -399 0 3193 3188 -399 0 3193 3188 -399 0 3193 3188 -399 0 3193 3188 -399 0 3193 3188 -399 0 3193 3188 -399 0 3193 3188 -399 0 3193 3188 -399 0 3193 3188 -399 0 3193 3188 -399 0 3193 3188 -399 0 3193 3188 -399 0 3193 3188 -35 0 3185 3186 3185 3186 3185 3186 3185 -357 0 3193 3188 -34 0 3191 3192 3191 3192 3191 3192 3191 -358 0 3193 3188 -33 0 3185 3186 -364 0 3193 3188 -32 0 3191 3192 -365 0 3193 3188 -399 0 3193 3188 -399 0 3193 3183 3184 3183 3184 3183 3184 3183 3184 3183 3184 3183 3184 3183 3184 3183 3184 3183 3184 3183 3184 3183 3184 3183 3184 3183 3184 3183 3184 3183 3184 3183 3184 3183 3184 3183 3184 3183)
    )
    (tilemap
      (solid #t)
      (alpha 0)
      (z-pos 1)
      (name "a")
      (width 400)
      (height 65)
      (tiles -25193 0 3203 3189 -398 0 3203 3190 -405 0)
    )
    (trampoline
      (type "stationary")
      (z-pos 50)
      (x 7968)
      (y 480)
    )
    (trampoline
      (type "stationary")
      (z-pos 50)
      (x 8000)
      (y 480)
    )
  )
)
