(supertux-level
  (version 3)
  (name (_ "A Cactusless Desert"))
  (author "Sophie Ball")
  (license "CC-BY-SA 4.0 International")
  (allow-item-pocket "inherit")
  (icon "")
  (icon-locked "")
  (statistics
    (enable-coins #t)
    (enable-badguys #f)
    (enable-secrets #t)
  )
  (sector
    (name "main")
    (init-script "Tux.deactivate();")
    (ambient-light
      (color 1 1 1)
    )
    (background
      (scroll-offset-y 550)
      (color 1 1 1)
      (alignment "bottom")
      (speed 0.2)
      (image "/images/background/desert/arcticmountains.png")
    )
    (background
      (scroll-offset-y -300)
      (color 1 1 1)
      (alignment "top")
      (speed 0)
      (image "/images/background/desert/sun.png")
      (z-pos -301)
    )
    (background
      (color 1 1 1 0.3)
      (speed 1)
      (image "/images/decal/misc/heatshimmer.sprite")
      (z-pos 301)
    )
    (camera
      (name "Camera")
      (mode "normal")
    )
    (decal
      (z-pos -102)
      (sprite "/images/decal/forest/ghost-bush-1.png")
      (x 352)
      (y 864)
    )
    (decal
      (z-pos -99)
      (sprite "/images/decal/forest/ghost-bush-1.png")
      (x 928)
      (y 864)
    )
    (decal
      (z-pos -102)
      (sprite "/images/decal/forest/ghost-bush-1.png")
      (x 1440)
      (y 864)
    )
    (decal
      (z-pos -102)
      (sprite "/images/decal/forest/ghost-bush-1.png")
      (x 2048)
      (y 864)
    )
    (decal
      (z-pos 99)
      (sprite "/images/decal/forest/ghost-bush-1.png")
      (x 2784)
      (y 864)
    )
    (gradient
      (top_color 0.3 0.4 0.75)
      (bottom_color 1 1 1)
      (z-pos -303)
    )
    (gradient
      (top_color 0.9372549 1 0.6509804 0.3)
      (bottom_color 1 0.9607843 0.8078431 0.1)
      (z-pos 300)
    )
    (gradient
      (top_color 1 0.9254902 0.6117647 0.1)
      (bottom_color 0 0 0 0)
      (z-pos -302)
    )
    (music
      (file "/music/worldmap/tropicalbreeze.music")
    )
    (scripttrigger
      (script "Text.set_font(\"normal\");
wait(0.5);

Text.set_text(\"Tux had gone to the Desolate Desert, even though he knew it was gonna be terrible...\");
Text.fade_in(1);
wait(4);
Text.fade_out(1);
wait(1);

Text.set_text(\"He could see the sun, but no cactus anywhere!\");
Text.fade_in(1);
wait(4);
Text.fade_out(1);
wait(1);

Tux.walk(300);

Text.set_text(\"He had to get through this if he wanted to get his crystals back.\");
Text.fade_in(1);
wait(4);
Text.fade_out(1);
wait(1);
Effect.fade_out(2);
wait(2);
Level.finish(true);")
      (button #f)
      (width 32)
      (height 32)
      (x 80)
      (y 928)
    )
    (scripttrigger
      (script "Tux.do_jump(-400);")
      (button #f)
      (width 32)
      (height 32)
      (x 1888)
      (y 928)
    )
    (spawnpoint
      (name "main")
      (x 80)
      (y 896)
    )
    (tilemap
      (solid #f)
      (z-pos -100)
      (width 100)
      (height 35)
      (tiles -2306 0 4723 4724 4725 -21 0 4723 4724 4725 -15 0 4723 4724 4725 -19 0 4723 4724 4725 -14 0 4723 4724 4725 -16 0 4726 4727 4728 -21 0 4726 4727 4728 -15 0 4726 4727 4728 -19 0 4726 4727 4728 -14 0 4726 4727 4728 -16 0 4729 4730 4731 -21 0 4729 4730 4731 -15 0 4729 4730 4731 -19 0 4729 4730 4731 -14 0 4729 4730 4731 -16 0 4732 4733 4734 -21 0 4732 4733 4734 -15 0 4732 4733 4734 -19 0 4732 4733 4734 -14 0 4732 4733 4734 -16 0 4735 4736 4737 -21 0 4735 4736 4737 -15 0 4735 4736 4737 -19 0 4735 4736 4737 -14 0 4735 4736 4737 -16 0 4738 4739 4740 -21 0 4738 4739 4740 -15 0 4738 4739 4740 -19 0 4738 4739 4740 -14 0 4738 4739 4740 -16 0 4741 4742 4743 -5 0 4762 4763 4764 4763 4764 4763 4764 4765 -8 0 4741 4742 4743 0 4762 4763 4764 4763 4764 4763 4764 4763 4764 4763 4764 4763 4764 4765 4741 4742 4743 -3 0 4762 4763 4764 4765 -8 0 4762 4763 4764 4765 4741 4742 4743 -2 0 4762 4763 4764 4763 4764 4763 4764 4765 -4 0 4741 4742 4743 -5 0 4762 4763 4764 4765 -501 0)
    )
    (tilemap
      (solid #f)
      (z-pos 100)
      (width 100)
      (height 35)
      (tiles -3500 0)
    )
    (tilemap
      (solid #t)
      (z-pos 0)
      (width 100)
      (height 35)
      (tiles -2900 0 4666 4667 -2 0 4665 -54 4666 4667 -5 0 4665 -34 4666 4669 4670 2085 2086 4668 -54 4669 4670 -5 0 4668 -35 4669 4670 2087 2088 4668 -54 4669 4670 -5 0 4668 -35 4669 4670 2087 2088 4668 -54 4669 4670 -5 0 4668 -35 4669 4670 2087 2088 4668 -54 4669 4670 -5 0 4668 -35 4669 4670 2087 2088 4668 -54 4669 4670 -5 0 4668 -34 4669)
    )
    (tilemap
      (solid #t)
      (tint 0 1 0)
      (z-pos -1)
      (width 100)
      (height 35)
      (tiles -3159 0 2136 2137 2138 2139 2136 2137 2138 -93 0 -7 4004 -93 0 -7 4004 -93 0 -7 4004 -34 0)
    )
    (tilemap
      (solid #f)
      (z-pos -101)
      (width 100)
      (height 35)
      (tiles -2800 0 4154 4155 -16 0 2518 4153 4154 4155 -17 0 2518 4153 4154 4155 -31 0 2533 2534 2539 2540 -2 0 2518 4153 4154 4155 -12 0 2518 4153 4154 4155 2531 2532 -2 0 2516 2517 -4 0 2634 2515 -3 0 2516 2517 0 2529 2530 2531 2532 322 2634 2515 -2 0 2516 2517 -5 0 2516 2517 0 2634 2515 2529 2530 2531 2532 0 2516 2517 -2 0 322 -2 0 2516 2517 0 2634 2515 -12 0 2516 2517 322 0 2634 2515 2541 2542 2543 2544 2516 2517 2529 2530 2531 2532 2634 2515 0 322 -3 0 2516 2517 0 2634 2515 2529 2530 2531 2532 -500 0)
    )
  )
)
