(supertux-level
  (version 3)
  (name (_ "Desolate Desert"))
  (author "SuperTux Player")
  (license "CC-BY-SA 4.0 International")
  (allow-item-pocket "on")
  (icon "")
  (icon-locked "")
  (sector
    (name "main")
    (ambient-light
      (color 1 1 1)
    )
    (decal
      (z-pos 50)
      (sprite "/images/decal/worldmap/pyramid.png")
      (x 1312)
      (y 128)
    )
    (level
      (z-pos 50)
      (level "act1.stl")
      (x 26)
      (y 10)
    )
    (level
      (z-pos 50)
      (level "act2.stl")
      (x 26)
      (y 14)
    )
    (level
      (z-pos 50)
      (x 37)
      (y 13)
    )
    (level
      (z-pos 50)
      (x 19)
      (y 14)
    )
    (music
      (file "/music/worldmap/tropicalbreeze.music")
    )
    (teleporter
      (z-pos 50)
      (worldmap "/levels/sickly_sewers/worldmap.stwm")
      (sector "main")
      (spawnpoint "main")
      (message (_ "Go back to Sickly Sewers?"))
      (x 8)
      (y 13)
    )
    (teleporter
      (z-pos 50)
      (message (_ "Go to Pyramid Panic Zone?"))
      (x 39)
      (y 13)
    )
    (tilemap
      (solid #f)
      (z-pos -100)
      (width 100)
      (height 35)
      (tiles -3500 1)
    )
    (tilemap
      (solid #t)
      (z-pos 0)
      (width 100)
      (height 100)
      (tiles -624 0 688 -4 689 690 -92 0 688 689 705 -4 693 704 -2 689 690 -86 0 688 -2 689 705 -9 693 704 689 690 -82 0 688 689 705 -14 693 704 689 690 -76 0 688 -3 689 705 -18 693 704 689 690 -72 0 688 689 705 -24 693 704 690 -68 0 688 -2 689 705 -27 693 694 -68 0 692 -30 693 694 -68 0 692 -30 693 694 -68 0 696 701 -29 693 694 -69 0 696 701 -28 693 694 -70 0 696 701 -27 693 694 -71 0 696 697 701 -23 693 700 697 698 -73 0 696 697 701 -19 693 700 697 698 -77 0 696 -3 697 701 -10 693 700 -4 697 698 -83 0 696 -10 697 698 -7869 0)
    )
    (tilemap
      (solid #t)
      (z-pos 1)
      (width 100)
      (height 100)
      (tiles -627 0 717 718 719 -95 0 356 0 720 721 722 -90 0 708 709 710 0 726 0 552 723 724 727 -90 0 711 712 713 233 -5 0 543 0 233 708 709 710 -83 0 543 0 714 715 727 0 10 -3 20 11 0 727 0 711 712 713 -79 0 552 -4 0 552 -4 0 21 717 718 719 21 -2 0 543 714 715 727 0 727 -75 0 356 -2 0 726 0 552 -2 0 356 0 726 0 21 720 721 722 21 0 10 20 11 -3 0 356 0 233 -69 0 26 -4 20 11 0 356 0 543 548 -3 549 550 0 21 723 724 727 21 0 21 0 21 0 552 0 10 -2 20 29 -69 0 233 -3 0 14 -10 20 16 -3 20 16 20 15 0 21 -3 0 21 0 543 -72 0 543 -8 0 543 -7 0 543 -3 0 14 -3 20 15 -75 0 552 -4 0 233 552 -5 0 543 -10 0 548 549 550 552 -77 0 727 -8 0 233 -4 0 552 -91 0 727 -11 0 727 -83 0 726 -9 0 727 0 233 -92 0 552 -7976 0)
    )
    (tilemap
      (solid #f)
      (z-pos 100)
      (width 100)
      (height 100)
      (tiles -1514 0 717 718 719 -97 0 720 721 722 -3 0 708 709 710 -9 0 708 709 710 -79 0 723 724 725 -3 0 711 712 713 -3 0 717 718 719 -3 0 711 712 713 -85 0 714 715 716 -3 0 720 721 722 -3 0 714 715 716 -91 0 723 724 725 -8071 0)
    )
    (worldmap-spawnpoint
      (z-pos 50)
      (name "main")
      (x 9)
      (y 13)
    )
  )
  (tileset "images/ice_world.strf")
)
